如何开启装饰物商店功能？	<div>您好，所在服开服时间≥84天或已经开过一次曙光之地活动后才可以在金融中心里看到装饰物商店页签，且需要满足玩家基地等级≥60级后才可以解锁装饰物商店功能。</div>
满足什么条件才能进行全息幻视?	<div dir="ltr" data-zone-id="0" data-line-index="0" data-line="true">您好，全息幻视需要满足以下两个基本条件：</div> <div data-zone-id="0" data-line-index="1" data-line="true"> </div> <div data-zone-id="0" data-line-index="2" data-line="true">1)您已经拥有了想要幻视的目标城市外观，且当前城市外观和目标城市外观都需要是永久城市外观；</div> <div data-zone-id="0" data-line-index="3" data-line="true">2)目标城市外观假如为可升级类型的城堡皮肤，需要达到最高等级后，才能够被幻视。</div>
为什么我们服没有全息幻视功能？	<div data-zone-id="0" data-line-index="0">您好，需要玩家所在服开完一次曙光之地活动后才能使用该功能哦，如果您所在服还没满足该条件的话，还请您耐心等待一下呢~</div>
为何我没有装饰主题公园这个建筑？	<div dir="ltr" data-zone-id="0" data-line-index="0" data-line="true">您好，需要达到基地等级78级后才能看到这个建筑哦，达到78级后可以在主页左下角的建筑列表里点击对应建筑图标，将该建筑放置在基地上。</div>
橙色装备改造功能的开启条件是什么？	<div>您好，需要玩家装备4件橙色装备后，才能开启橙色装备改造功能。符合开启条件后玩家可以在军火库改造页面内将装备进行进阶操作。装备改造后可以获得额外属性，额外属性在佩戴装备后可对对应兵种生效。</div>
每个橙色装备最多可以改造到多少阶？	<div data-zone-id="0" data-line-index="0" data-line="true">您好，目前的设定是每个橙色装备最多可以改造到8阶。4件橙色装备改造品阶总和达到一定值后可以激活额外套装属性效果。</div>
分解已经改造过的橙色装备时，改造材料会返还吗？	<div dir="ltr">分解已经改造过的橙色装备时，装备制造和改造消耗的材料、以及装备改造消耗的改造图纸会返还，但是装备制造图纸不会返还~</div>
暗月币可以留待下次使用吗？	<div data-zone-id="0" data-line-index="0" data-line="true"> 您好，暗月节活动规则中有写明暗月币在活动结束后会被清空，还请您及时使用，避免不必要的损失。</div>
暗月节活动摩擦神灯时体力和暗月币的兑换比例是多少？	<div dir="ltr">您好，摩擦时体力跟暗月币有兑换比例（1:2），摩擦时还有可能触发暴击效果（请根据摩擦时活动页面显示的暴击倍率为准）。</div>
我要给你们提个建议！	<p dir="ltr" style="word-wrap: break-word;">感谢您的支持，我们对玩家的建议都是非常重视的，您可以点击右上角联系客服-我要提交建议填写您的建议内容并提交，我们会转达给团队进行考量。<br /><br /><a href="https://aihelp.net/questionnaire/#/?formId=c50e4dfe737b4f949577047bc39e9725">建议提交</a></p>
我怎么迁移区服，需要什么道具资源	<p style="word-wrap: break-word;">开启迁出功能的服务器可以在世界地图（能看到各个服务器的那个地图）点击左下角第二个按钮查看迁服列表，如果满足调动要求，点击 准备调动 之后会显示相关说明和所需 调动申请书 的数量哦~</p>
我的强化页面显示有三个高速开火为什么不能合成，在背包就显示一个	<p style="word-wrap:break-word">因为同一个部件可以同时安装在强化部件的四个分页，需要把四个分页部件都卸到背包中再进行合成</p>
希望换职业时可以实现狗牌和齿轮的互换	<p dir="ltr" style="word-wrap: break-word;">我们预计会进行职业系统的重构，重构之后每个职业特色会更加鲜明，玩法会更加丰富。在职业重构完成之后，当前的职业所有消耗的资源会重置，现在的狗牌和齿轮也会转变为全新职业系统的升级材料。 所以不用担心因为现在的选择会导致资源废弃，让我们一起期待更有趣的全新职业玩法的到来！</p>
强化部件	<p style="word-wrap:break-word">强化部件最多可以装几个？    每个兵种最多可以装五个。<br />强化部件一共有多少个。    一共有10个，选择不同的强化部件组合，会有不同的效果哦。<br />兵种克制一共有多少级？    一共有100级，满级的强化克制能产生120%的效果。<br />安装强化时有3个相同的强化但是背包里不显示/无法合成？    需要将强化界面的4个分页中的对应强化都卸下才可以喔</p>
出征队列	<div dir="ltr"> <p style="word-wrap:break-word">目前游戏内默认包含1个出征队列。</p> <p style="word-wrap:break-word">黑金百夫长（原至尊永久卡）和铂金指挥官卡（原精英月卡）各自包含1个出征队列。</p> <p style="word-wrap:break-word">简易指挥所达到25时增加1个出征队列。</p> <p style="word-wrap:break-word">职业天赋的见习军官中的骁勇善战研究完成后增加1个出征队列。</p> <p style="word-wrap:break-word">首府的首领官职会增加1个出征队列。</p> <p style="word-wrap:break-word">同时在您创建新角色的时候，系统会通过游戏内活动向您赠送一个限时增加出征队列的道具，此类道具使用后，您可以在倒计时内增加一个额外出征队列，使用多个限时队列道具只叠加时间，不会额外获得更多队列，有效期结束后，该队列会被取消。</p> </div>
装饰	<p dir="ltr" style="word-wrap: break-word;">15级解锁神奇宝箱建筑，每隔一定时间会获得装饰宝箱.</p><br/><p style="word-wrap: break-word;"><br />装饰物宝箱开出来的装饰物，放在主城里，可以修饰主城并带来各种BUFF，最多生效有数量限制，说明里有写，放置后也可随时回收到包裹里。</p><br/><p style="word-wrap: break-word;"><br />放置之后的buff效果，装饰属性可以在建筑神奇宝箱里面的buff分页看到，所有的装饰属性可以在buff旁边的图鉴分页点击查看。<br /><br />有关装饰品合成问题：<br />①在整体数量生效有限制的情况下，三合一升级更高一级的时候没有直接按照玩家理解的原有属性*3叠加，是一级比一级更高；</p><br/><p style="word-wrap: break-word;"><br />②由于目前游戏内显示的最多是一位小数，所以有一些级别增加了但是没有显示出来，导致玩家认为没有增加，例如从0.2提升到0.24，游戏内目前显示都是0.2；</p><br/><p style="word-wrap: break-word;"><br />③高等级装饰可以分解为低等级装饰。</p>
新区开放	<p dir="ltr">我们会不定期开放新服务器，您可以留意下头像-设置-角色管理里的服务器列表。</p>
援助	<p dir="ltr">10级可建造战争大厅，建造后即可援助盟友，在基地中点击战争大厅上面的图标可以查看被援助的记录。<br />点击盟友的基地可以选择援助，被援助的基地被攻击时，增援部队按照战力降序排列上阵，最后是基地防守的士兵出战。强化部件效果按各自的属性。</p>
经验	<p style="word-wrap: break-word;">游戏内经验获取是通过金币消耗来实现的，消耗5金币=获取1经验。（帮助联盟成员的金币除外）</p><br/><p style="word-wrap: break-word;">同时游戏内显示经验单位较大，会以四舍五入形式显示，获取少量经验情况下，可能无法直接通过游戏内显示的结果查看到，但是系统已经为您增加，请您不必担心。</p><br/><p style="word-wrap: break-word;"> </p><br/><p style="word-wrap: break-word;">您可以点击左上角查看当前升级所需要的经验。</p><br/><p style="overflow-wrap: break-word;"><br />联盟科技-勤俭节约：只减少消耗的金币，不减少获得的经验。</p><br/><p style="overflow-wrap: break-word;"> </p>
联盟保卫战	"<p style=""word-wrap:break-word"">问：<span style=""white-space: pre;"">	</span>联盟保卫战开启条件<span style=""white-space: pre;"">	</span></p><p style=""word-wrap:break-word"">答：<span style=""white-space: pre;"">	</span>玩家至少有一个联盟且联盟有一个联盟堡垒。只有盟主才能报名开启。报名时可以选择XX小时后开启。</p><p style=""word-wrap:break-word"">问：<span style=""white-space:pre"">	</span>如果参加防守据点<span style=""white-space:pre"">	</span></p><p style=""word-wrap:break-word"">答：<span style=""white-space:pre"">	</span>玩家可以点击开启联盟保卫战的联盟据点，点击之后点击驻守，在点增员就可以参加保卫据点</p><p style=""word-wrap:break-word"">问：<span style=""white-space:pre"">	</span>如何知道那个据点在参加保卫战<span style=""white-space:pre"">	</span></p><p style=""word-wrap:break-word"">答：<span style=""white-space:pre"">	</span>可以点击活动，点击前往据点，或者查看堡垒，就可以找到参与活动的联盟据点。</p><p style=""word-wrap:break-word"">问：<span style=""white-space:pre"">	</span>联盟保卫战期间为什么没办法加入联盟<span style=""white-space:pre"">	</span></p><p style=""word-wrap:break-word"">答：<span style=""white-space:pre"">	</span>该联盟从报名联盟保卫战开始就无法加入联盟，只有该联盟保卫战结束之后，才可以在进行申请</p><p style=""word-wrap:break-word"">问：<span style=""white-space:pre"">	</span>联盟保卫战积分如何获得<span style=""white-space:pre"">	</span></p><p style=""word-wrap:break-word"">答：<span style=""white-space:pre"">	</span>可以杀死怪物，或者使用精科导弹削弱怪物跟修理联盟堡垒都可以获得积分</p><p style=""word-wrap:break-word"">问：<span style=""white-space:pre"">	</span>精科导弹哪里获取<span style=""white-space:pre"">	</span></p><p style=""word-wrap:break-word"">答：<span style=""white-space:pre"">	</span>击杀大地图上的野怪有一定概率获取精准导弹</p><p style=""word-wrap:break-word"">问：<span style=""white-space:pre"">	</span>精科导弹有什么用<span style=""white-space:pre"">	</span></p><p style=""word-wrap:break-word"">答：<span style=""white-space:pre"">	</span>1.可以修理联盟堡垒的血量。  2.可以降低当前波次攻城怪物的实力。</p><p style=""word-wrap:break-word"">问：<span style=""white-space:pre"">	</span>如何能打高分<span style=""white-space:pre"">	</span></p><p style=""word-wrap:break-word"">答：<span style=""white-space:pre"">	</span>建议不要急着打，联保保卫战是联盟所有人的事，所以先准备充足的精科导弹，人员齐备之后再开启。精科导弹可以降低怪物的实力，可以修理堡垒</p><p style=""word-wrap:break-word"">问：<span style=""white-space:pre"">	</span>换盟能重打吗？积分和奖励怎么计算？<span style=""white-space:pre"">	</span></p><p style=""word-wrap:break-word"">答：<span style=""white-space:pre"">	</span>换盟可以重新打，排行榜积分记录在新盟，已经领取的波次奖励和积分奖励无法重复领取。</p><p style=""word-wrap:break-word""><br/></p>"
如何为FAQ设置关键词？	<p style="word-wrap:break-word">首先要抓住每一条FAQ的核心词汇，一般是名词和动词，名词为主，动词为辅。</p><p style="word-wrap:break-word">举个例子：</p><p style="word-wrap:break-word">“如何创建联盟？”和“如何加入联盟？”这两条FAQ怎么配关键词呢？</p><p style="word-wrap:break-word">分别是：联盟,建*盟 和 联盟,加*盟</p><p style="word-wrap:break-word">之所有这两个都有“联盟”这个关键词，是因为如果用户问的问题很模糊，就想问跟“联盟”相关的，那这样配置就可以保证把相关的FAQ都展示给用户。</p><p style="word-wrap:break-word">然后“建*盟”和“加*盟”是为了提高准确度。比如用户就是想知道如何创建联盟。这样配置后，就只会展示第一条FAQ，而不会展示其他的，除非你在别的FAQ里也配了“建*盟”这个关键词。这样就能保证匹配的准确度了。</p><p style="word-wrap:break-word"> </p><p style="word-wrap:break-word">那这个“*”号是什么意思呢？</p><p style="word-wrap:break-word">*号代表任意字符，只要用户问的问题，符合“建*盟”的规则，就都会展示这条FAQ。比如：</p><p style="word-wrap:break-word">“我想创建个联盟，怎么操作？”</p><p style="word-wrap:break-word">“怎么建立联盟啊，我想跟朋友一起玩。”</p><p style="word-wrap:break-word">对于英文等符号语言的FAQ，*号两边需要加空格，比如create * alliance</p><p style="word-wrap:break-word"> </p><p style="word-wrap:break-word">PS：</p><p style="word-wrap:break-word">1.一开始配置关键词的时候没必要想的太全面，如果把用户有可能问到的各个说法都想要照顾到的话，一方面工作量太大，另一方面你也不知道用户是不是一定会这样问。</p><p style="word-wrap:break-word">所以最好的方法是，先简单把最常规的问法覆盖到，之后AIhelp这边会有很多工具，自动找出用户跟机器人沟通的有价值的问答历史，快速的帮助您优化FAQ和关键词。</p><p style="word-wrap:break-word"></p><p style="word-wrap:break-word">2. 关键词是不需要加任何符号的，关键词间用中文或者英文逗号（顿号，分号也可以）隔开就行。例如：礼包,金币,钻石,宝石</p>
新岛屿大作战FAQ	<p style="word-wrap: break-word;">1<span style="white-space: pre;"> </span>问<span style="white-space: pre;"> 新</span>岛屿大作战共有多少层？</p><br/><p style="word-wrap: break-word;"><span style="white-space: pre;"> </span>答<span style="white-space: pre;"> </span>共有15层。</p><br/><p style="word-wrap: break-word;">2<span style="white-space: pre;"> </span>问<span style="white-space: pre;"> </span>如何攻击小岛上的怪物？</p><br/><p style="word-wrap: break-word;"><span style="white-space: pre;"> </span>答<span style="white-space: pre;"> </span>拖动直升机到各个岛屿会自动打滑动路线上的岛屿。或者挨个点击每层怪物，点击攻击。</p><br/><p style="word-wrap: break-word;">3<span style="white-space: pre;"> </span>问<span style="white-space: pre;"> </span>增益是怎么来的？</p><br/><p style="word-wrap: break-word;"><span style="white-space: pre;"> </span>答<span style="white-space: pre;"> </span>增益是走到问号，会随机给炸弹，或者给一个增益效果，同时也可以选择增益岛屿。</p><br/><p style="word-wrap: break-word;">4<span style="white-space: pre;"> </span>问<span style="white-space: pre;"> </span>为什么有的是增益5%有的是增益8%？</p><br/><p style="word-wrap: break-word;"><span style="white-space: pre;"> </span>答<span style="white-space: pre;"> </span>12层之后到问号箱子中随机出来的效果是8%，12层之前的都是5%。</p><br/><p style="word-wrap: break-word;">5<span style="white-space: pre;"> </span>问<span style="white-space: pre;"> </span>问号箱子给什么？</p><br/><p style="word-wrap: break-word;"><span style="white-space: pre;"> </span>答<span style="white-space: pre;"> </span>会随机地雷，或者随机出增益效果。</p><br/><p style="word-wrap: break-word;">6<span style="white-space: pre;"> </span>问<span style="white-space: pre;"> </span>战功有什么用？</p><br/><p style="word-wrap: break-word;"><span style="white-space: pre;"> </span>答<span style="white-space: pre;"> </span>战功可以在右上角的商店中兑换商品。</p><br/><p style="word-wrap: break-word;">7<span style="white-space: pre;"> </span>问<span style="white-space: pre;"> </span>小岛大作战一天可以参与几次？</p><br/><p style="word-wrap: break-word;"><span style="white-space: pre;"> </span>答<span style="white-space: pre;"> </span>每天可以重置两次。</p><br/><p style="word-wrap: break-word;">8<span style="white-space: pre;"> </span>问<span style="white-space: pre;"> </span>战报如何看？</p><br/><p style="word-wrap: break-word;"><span style="white-space: pre;"> </span>答<span style="white-space: pre;"> </span>点击战报即可，最新的战报在顶层显示。</p><br/><p style="word-wrap: break-word;">9<span style="white-space: pre;"> </span>问<span style="white-space: pre;"> </span>小岛大作战为什么有的怪物战力高，有的战力低？</p><br/><p style="word-wrap: break-word;"><span style="white-space: pre;"> </span>答<span style="white-space: pre;"> </span>战力高给的奖励越高哦。</p><br/><p style="word-wrap: break-word;">10<span style="white-space: pre;"> </span>问<span style="white-space: pre;"> </span>小岛大作战什么配置可以通过？</p><br/><p style="word-wrap: break-word;"><span style="white-space: pre;"> </span>答<span style="white-space: pre;"> </span>小岛大作战实力跟运气缺一不可，无法说出准确的配置还请见谅。</p><br/><p style="word-wrap: break-word;"> </p>
如何创建FAQ？	<p style="word-wrap:break-word">您可以通过下列3种方法创建FAQ：</p><p style="word-wrap:break-word">1.打开<b>机器人→常见问题</b>，选择一条FAQ的分类，点击页面上的“<b>新建FAQ</b>”按钮，输入问题，答案，摘要和关键词即可生成一条FAQ。</p><p style="word-wrap:break-word">2. AIhelp支持把已有的FAQ导入到客服后台。详情请参考：<a href="https://aihelp.net/FAQ/#/AIHelp-Support/app/zh-CN/EB5AE263D8AB85A4/B220E6AE8654FD45/6689E0F8F7D060A8" target="_blank">FAQ的导入导出</a></p><p style="word-wrap:break-word"></p><p style="word-wrap:break-word">3. 您也可以从AIhelp服务的其他项目拷贝FAQ到您自己的项目，前提是需要该项目的邀请码。详情请参考：<a href="https://aihelp.net/FAQ/#/AIHelp-Support/app/zh-CN/EB5AE263D8AB85A4" target="_blank">FAQ，故事线和表单从其他项目拷贝</a></p>
悬赏任务、军阶、军票	<p style="overflow-wrap: break-word;">【悬赏任务】</p><p style="overflow-wrap: break-word;">每天最多可以完成10个悬赏任务。</p><p style="overflow-wrap: break-word;">任务内容以及品质可以通过刷新变更，单日免费刷新次数为：5次。后续需要使用钻石刷新。</p><p style="overflow-wrap: break-word;"><br/></p><p style="overflow-wrap: break-word;">【任务内容】</p><p style="overflow-wrap: break-word;">任务包含采集、建造建筑、训练士兵完成、购买道具、税收中心等操作。</p><p style="overflow-wrap: break-word;">任务品质由低到高依次为：高级、稀有、精英、史诗、传说。</p><p style="overflow-wrap: break-word;"><br/></p><p style="overflow-wrap: break-word;">【任务奖励】</p><p style="overflow-wrap: break-word;">点击任务前的宝箱标记可以查询当前任务可以领取的奖励内容。</p><p style="overflow-wrap: break-word;">基地等级越高、任务品质越高，奖励内容越多。</p><p style="overflow-wrap: break-word;"><br/></p><p style="overflow-wrap: break-word;">【军票】</p><p style="overflow-wrap: break-word;">完成任务可以得到军票，军票可以用于军团商店购买道具。</p><p style="overflow-wrap: break-word;"><br/></p><p style="overflow-wrap: break-word;">【军阶、军阶晋升】</p><p style="overflow-wrap: break-word;">军阶包含：<span style="font-family: "lucida Grande", Verdana; font-size: 14px; background-color: rgb(255, 255, 255);">新兵-二等兵-一等兵-上等兵-下士-中士-上士-少校-中校-大校-少将。</span></p><p style="overflow-wrap: break-word;"><span style="font-family: "lucida Grande", Verdana; font-size: 14px; background-color: rgb(255, 255, 255);">提升军阶需要完成不同品质任务对应数量。</span></p><p style="overflow-wrap: break-word;"><span style="font-family: "lucida Grande", Verdana; font-size: 14px; background-color: rgb(255, 255, 255);">提升军阶后可以解锁更多的军团商店购买品类。</span></p><p style="overflow-wrap: break-word;"><span style="font-family: "lucida Grande", Verdana; font-size: 14px; background-color: rgb(255, 255, 255);"><br/></span></p><p style="overflow-wrap: break-word;"><br/></p><p style="overflow-wrap: break-word;"><br/></p>
如何创建和删除一条【分类】?	<p style="word-wrap:break-word">在AIhelp客服后台的<b>机器人→常见问题→【分类】</b>页面，</p><p style="word-wrap:break-word">点击“<b>新增分类</b>”按钮，输入分类名称和顺序编号，再点击保存后就可以创建一条分类。</p><p style="word-wrap:break-word">点击一个分类后面的“<b>删除</b>”按钮，即可删除一条分类。</p>
重选职业后会返还我的资源和道具吗？	<p style="word-wrap:break-word">重选职业/分支之后，属性不保留，会返还之前已经研究完成的职业天赋所消耗的全部资源和道具，会按照研究职业天赋所需时间返还加速道具。<br />请注意，正在研究中的职业天赋不会返还任何资源和道具。</p>
为什么我有出征上限+1，但是我的队列数量没有增加？	出征上限+1指的是您一个队列里的带兵数量上限+1，并不是队列数+1哦
我换手机了，原来绑定QQ的App角色怎么登录啊	<p dir="ltr">您在新手机下载App之后点击游客登录，进入游戏点击头像-设置-账号绑定选择QQ进行登录即可</p>
自动加入集结	<p style="word-wrap:break-word">点击联盟-战争-左上方按钮【自动加入】可以设置：</p><p style="word-wrap:break-word">1.自动加入集结的兵力（单兵加入、全兵加入）<br/></p><p style="word-wrap:break-word">2.加入类型（战锤、砰砰、难民）</p><p style="word-wrap:break-word"><br/></p><p style="word-wrap:break-word">点击【自动加入】按钮右侧的滑动按钮，可以开启此功能。</p><p style="word-wrap:break-word"><br/></p><p style="word-wrap:break-word">重要提示：<span style="font-family: Arial; font-size: 13px; white-space: pre-wrap; background-color: rgb(255, 255, 255);">自动加入功能一次开启后持续8个小时。8个小时后，会自动关掉。</span></p>
皮肤	<p style="word-wrap:break-word">购买超级月卡后，可以在月卡持续期间使用月卡皮肤。<br>其他皮肤外观需要活动获得。可以点击头像查看各种皮肤的获取途径。</p><p style="word-wrap:break-word"><br>普通基地占用地块1*1，其他皮肤占用地块2*2，<br>如果购买月卡不自动装扮外观，需要迁移至空旷区域手动装扮。</p><p style="word-wrap:break-word"><br></p><p style="word-wrap:break-word">皮肤属性分为2种：</p><p style="word-wrap:break-word">拥有属性，是指，只要您拥有了这个皮肤，不需要装备就可以用有属性。</p><p style="word-wrap:break-word">使用属性，是指，您使用这个皮肤的时候才会生效。</p><p style="word-wrap:break-word"><br></p>
联盟	<p dir="ltr">【加入联盟】<br />基地5级后可以加入联盟，加入联盟后可以与盟友在联盟频道进行交流、分享坐标、交换矿石等。<br />集结<br />战锤、砰砰需要盟友集结才能攻击。<br /><br />【联盟积分】<br />捐献联盟科技可以获得联盟积分，用以在联盟商店兑换道具。<br /><br />【联盟礼物】<br />联盟成员购买6元及以上的特惠礼包（礼包界面显示有联盟礼物的礼包）后，全盟成员都会收到联盟礼物喔（联盟礼物会通过邮件发送）。<br /><br />【升级、逐出联盟】<br />点击联盟-成员-点击管理-可以逐出联盟或者升降级。<br />点击联盟-设置-可以离开联盟，如果是盟主，需要您将盟主让位给其他盟友才能退盟。<br /><br />【联盟堡垒】<br />建造联盟堡垒可以形成联盟领地，盟主和R4可以拆除联盟堡垒。<br /><br />【联盟迁城】<br />盟主和R4可以点击联盟堡垒-邀请迁城可以邀请盟友将基地迁移到联盟领地内。</p><br/><p style="word-wrap:break-word"> </p><br/><p style="word-wrap:break-word">如何成为盟主/取代盟主</p><br/><p style="word-wrap:break-word">您可以创建一个新的联盟，成为联盟盟主。</p><br/><p style="word-wrap:break-word">同时您也可以通过取代当前联盟内盟主成为新一任联盟盟主。盟主超过一段时间不登录游戏，可以通过游戏内的联盟-设置-取代盟主，相关罢免条件会在对应页面显示。</p>
好友	<p style="word-wrap:break-word">点击头像-设置-好友可以查看好友列表。<br>世界聊天中可以点击头像添加好友~<br>在世界地图中点击其他玩家的基地-头像也有添加好友的选项喔~</p><p style="word-wrap:break-word"><br>可以在好友页面，点击“邀请好友”发送申请链接，好友点击即可成功添加。<br>如果不在同一个服务器就无法添加好友哦~</p>
车库	<p style="word-wrap: break-word;">车库相关建筑点击基地内下方的建筑列表可以放置。</p><br/><p style="word-wrap: break-word;"><br />建筑放置后，可以将地面上的士兵统一收纳到车库内。<br />收纳到车库中的士兵，仍然可以正常参加出征以及防御战斗。</p><br/><p style="word-wrap: break-word;"> </p><br/><p style="word-wrap: break-word;">车库这3个建筑容纳上限是150（不含城堡皮肤、城堡特效增加的数量）。</p><br/><p style="word-wrap: break-word;"><br />同时<br />1.在车库内滑动士兵可以进行合成（也可以一键合成）<br />2.按住士兵，点击红色删除按钮会进行删除操作</p>
钻石	<p style="word-wrap: break-word;">可以通过购买以及活动、观看视频等获得钻石。</p><br/><p style="word-wrap: break-word;"><br />ios微信小程序目前暂时无法进行充值。可以尝试在App Store下载ios客户端进行支付操作。</p><br/><p style="word-wrap: break-word;"> </p>
金币	<p style="word-wrap: break-word;">在游戏内可以通过税收中心/金币收割机、放置金矿生产金币，<br />同时有部分装饰是可以提高民居金币产量。</p><br/><p style="word-wrap: break-word;"> </p><br/><p style="word-wrap: break-word;">税收中心只需要20个当前玩家等级民居即可达到之前造满民居的收益。新版本（没有税收中心）的金币自动收割机是需要10个当前等级的金矿</p><br/><p style="overflow-wrap: break-word;"><br />金币箱子得到的金币数量为税收中心基础收益一半。</p>
为什么我买了至尊永久卡后，永久卡头像框不能设置	需要您在背包里使用该道具，再到个人中心页面或者聊天频道里进行设置
商店购买的石油粮食为什么在背包里找不到呢	从商店里购买的石油粮食不会在背包内显示哦，会直接加到总量里的
我经常忘记切换强化，有什么建议或者改善方法吗	感谢您的反馈，我们会把您的想法转达给团队的，后期可能会添加一个出征时强化选择提醒功能
在哪里能看到我刚刚获得的装备图纸	您可以在军火库制作对应装备的界面查看到您拥有的图纸
我购买的资源不见了	礼包购买或者箱子开出的资源道具会出现在背包里，其他资源会直接加入到资源总数中喔
为什么我买了精英月卡却没有获得钻石	精英月卡中并不包含钻石喔，精英月卡的特权是不用看视频，直接获得当天看视频可以获得的钻石，如果已经通过看视频获得了钻石，购买精英月卡时就不会获得这部分钻石了噢
自选兵种+1/+2宝箱获得的士兵等级是怎么算的？	是根据您的个人科技【士兵单位】的等级计算+1/+2，比如您当前的个人科技中【陆军单位】等级是80，可以通过该道具获得81/82级陆军士兵。
我使用了自选兵种+1/+2宝箱没有获得士兵	使用道具并选择您想要的士兵后，请您到背包里‘士兵’的选项里查看噢
为什么我的修理厂是空的，受伤的士兵却没有收进去	如果是在攻击其他玩家基地时产生的伤兵，那不会进入修理厂喔~<br/>VIP13-VIP16的特权可以按一定比例转化成伤兵进入修理厂
为什么我用了两个额外队列的道具，只增加了一个队列	如果使用多个额外限时队列道具，只会增加限时队列的持续时间，并不会增加队列数量。
不小心解锁错了雷神兵种，可以换成解锁其他雷神兵种吗？	<p dir="ltr">目前是不可以的哦，但是我们仍感谢您的反馈，我们会把您的想法转达给团队的，希望也能有在游戏中实现。</p>
我想给我的修理工厂扩容，为什么显示尚未开放。	使用修理工毕业证书最多增加6个修理车间，剩余的空间需要研究个人科技、通用职业天赋进行扩展，需要基地等级达到80级才能解锁通用职业天赋。
次元矿洞里，为什么同一个英雄不能同时驻守两个矿洞	<p dir="ltr">请您先在战争大厅预设编队，然后就可以使用同样的编队驻守不同的矿洞啦</p>
怎么建造第二个车库/船坞/机场呢	基地等级80级后通过研究通用职业天赋可以解锁第二个车库/船坞/机场哦
请问多少级才可以建造勋章系统建筑呢	勋章系统建筑是需要基地等级55级解锁的
有人在世界频道骂人/发布不当言论	<p dir="ltr">您可点击该玩家头像，点击红色举报按键与屏蔽按键，感谢您的支持。</p>
请问专属技能万能碎片在哪里获得？	<p style="word-wrap:break-word">可以通过不定期开放的各种活动玩法中获得，建议可以通过公告牌留意后续活动奖励以及礼包</p>
我收回的装饰品不见了	请您打开背包-建筑栏进行查看。
我发现有人买卖账号	我们不支持账号共享、交易等行为，但是玩家在游戏外的交流我们无法进行干涉，也不会处理因为帐户共享和交易引起的问题。<br/>我们了解到有玩家购买了角色，先前的拥有者进行了退款，因此该角色被系统封停的情况。所以建议玩家不要进行账号交易和共享，以免受到不必要的损失。
我升级了vip但是体力显示不正确	每个角色的基础体力为75，VIP加体力上限是基于基础体力的，请查看以下内容（无其他加成）：<br/>vip0 75<br/>vip1 75<br/>vip2 75<br/>vip3 75<br/>vip4 95<br/>vip5 105<br/>vip6 115<br/>vip7 125<br/>vip8 145<br/>vip9 165<br/>vip10 185<br/>vip11 205<br/>vip12 225<br/>vip13 265<br/>vip14 265<br/>vip15 265<br/>vip16 285
因为操作失误导致错误使用了道具，想回退怎么办？	<p dir="ltr">对于误操作的情况，VIP5以上可以提交误操作恢复申请，请点击右上角联系客服提交工单！请注意，三个月只能恢复一次！</p> <p dir="ltr">——————————</p> <p dir="ltr">我们一般只处理7天内发生的误操作行为（从发生到反馈的时间不超过7天，个别行为需要2小时内联系我们），同时并不是所有行为都可以申请误操作，比如在消耗钻石相关的活动期间消耗钻石或招募等操作结果存在随机性的的行为不能申请误操作。具体请联系游戏内客服进行确认。</p>
为什么基地最下面不能放士兵、兵营、船坞、车库、机场	等级达到62级且解锁全部常规地块后，可以开始解锁城内下方的非军事扩展区。该区域可以放置装饰物以及功能性建筑，而士兵、兵营、船坞、车库、机场等无法放置
礼品码怎么使用，在哪领取	点击头像-设置-礼品码进行兑换使用，获取方式请留意后续公告牌与游戏内公告邮件
我的获得的雷神元素背包里怎么看不见	需要80级之后解锁超级武器实验室建筑之后才可进行查看，80级前获得的雷神元素会正常累计增加
装饰属性在城市详情内怎么不显示啊	装饰属性是在神奇宝箱-buff界面进行显示的
旧的装饰套装比如假日酒店等能否返厂让人再次购买呢	计划后续会增加获取途径，建议可以通过公告牌留意后续活动奖励以及礼包
解除绑定	<p style="word-wrap:break-word">游戏账号无法解除或更换绑定，为了您的账号安全，我们不支持账号共享、交易等行为。</p>
账号同步	<p style="word-wrap: break-word;">如果您是ios用户，可以在游戏内点击头像，绑定ios和facebook账号。</p><br/><p style="word-wrap: break-word;">如果您是google用户，可以在游戏内点击头像，绑定google账号和facebook账号。</p><br/><p style="word-wrap: break-word;"> </p><br/><p style="word-wrap: break-word;">如果您之前使用的是ios设备登录游戏，同时绑定了facebook账号，目前如果您更换了google设备，可以通过谷歌商店下载我们的游戏，同时通过历史绑定的facebook账号登陆原游戏进度。</p><br/><p style="word-wrap: break-word;"> </p><br/><p style="word-wrap: break-word;"> </p><br/><p style="word-wrap: break-word;">！！！【注意】这条中文简体不开放哈！！！所以不需要给他添加关键字！！！！</p>
成长基金	<p style="word-wrap:break-word">在礼包商城-成长基金中可以购买，达到页面要求等级可以领取钻石。共可以领取13600钻石。</p><p style="word-wrap:break-word"><br>如您在购买之后无法进行领取，请您先尝试彻底关闭游戏后重新登录领取。</p>
vip	<p style="word-wrap:break-word">VIP等级需要点数（1点=付费1rmb）对应点数越多，vip等级越高。</p><p style="word-wrap:break-word">如果您希望提升vip等级~可以点击头像右边的vip按钮在vip页面查看距离下一个vip等级缺少多少点~<br/><br/>点击头像，选择【设置】可以开启关闭vip显示标记，vip显示关闭后，不显示vip标记，但是头像框和属性依然享受。</p>
客户端登陆微信游戏进度	<p style="word-wrap:break-word">如果您希望在ios或Android客户端中登陆微信小程序中的游戏进度，请您严格参考以下处理方案：</p><p style="word-wrap:break-word"><br/>1.删除客户端</p><p style="word-wrap:break-word"><br/></p><p style="word-wrap:break-word">2.在微信小程序【口袋奇兵】中点击头像，选择设置，选择角色管理，开始一个新的游戏进度</p><p style="word-wrap:break-word"><br/>3.重新下载最新的客户端</p><p style="word-wrap:break-word"><br/>4.在口袋奇兵客户端中，点击头像，选择【微信绑定】可以登录原有游戏进度</p>
买了成长基金为什么不能领取？	成长基金是需要达到一定的等级要求才能领取对应的钻石。
泰温礼包为什么没有了？还能再次购买吗？	泰温礼包是购买第一档礼包后，后续的礼包会有48小时倒计时，倒计时结束后礼包就消失了噢。<br/>错过之后无法购买，不过我们也会尽量不定期重新开启继续购买的活动，敬请留意
我想要退款需要怎么做？	我们是无法处理退款的，还请您联系付款平台（比如苹果或者微信平台等）协商退款事宜。<br/>退款之后，系统会按照礼包价格扣除双倍钻石，一些特殊礼包会扣除全部可获得的钻石（成长基金，周卡）
钻石是负数会有什么影响？	钻石负数不能使用征税、看视频、活动界面、聊天、改名、切换到世界地图、邮件等功能，并且购买的礼包不会计入充值活动。
为什么我的钻石是负数	<p dir="ltr">退款之后，系统会按照礼包价格扣除双倍钻石，一些特殊礼包会扣除全部可获得的钻石（成长基金，周卡）</p>
我的角色误删除了怎么恢复	需要在同一设备下创建一个新角色，点击右上角联系客服-账号问题-角色删除恢复联系我们并提供新建的角色识别码，核实正确会进行恢复，另外一个角色只能恢复一次，请您谨慎操作
我的是苹果手机充值没有到账并且重复扣费了	请您打开app store，点击右上角头像-点击邮箱名字的地方-点击购买记录查看下近期订单记录，进行对比核实。<br/>如果未到账的订单显示是处理中，可能存在延迟，您可以尝试重新进行购买操作并不要付款，即可到账。<br/>如果依然没有收到礼包，请点击右上角联系客服-充值问题提交工单
实名认证	<p style="word-wrap:break-word">一.严格控制未成年人使用网络游戏时段、时长。每日22时至次日8时，未成年人玩家将无法登录游戏。未成年人将限制游戏时长，每日累计不得超过1.5小时。<br />二.规范向未成年人提供付费服务。未满8周岁的玩家将禁止充值。同一网络游戏企业所提供的游戏付费服务，8周岁以上未满16周岁的玩家，单次充值金额不得超过50元人民币，每月充值金额累计不得超过200元人民币;16周岁以上未满18周岁的用户，单次充值金额不得超过100元人民币，每月充值金额累计不得超过400元人民币。 <br />三.未进行实名认证的玩家，将不可登录游戏。</p>
如何查看雷神元素？	<p dir="ltr">80级解锁<strong><span style="color: #e03e2d;">超级武器实验室</span></strong>建筑之后才可进行查看，80级前获得的雷神元素会<strong><span style="color: #e03e2d;">正常累计增加，不会有损失</span></strong>。<br /><img src="https://cdnimage.aihelp.net/FileService/SysFile/Faq/202212/202212091319271423846c93861.jpg" border="0" alt="" width="340" height="332" style="max-width: 100%; max-height: 100%;" /></p>
士兵	<p dir="ltr" style="word-wrap: break-word;">坦克有什么特性。</p><br/><p style="word-wrap: break-word;">坦克单位战地比较小，一个坦克只占一个格子，单体攻击，克制空军。</p><br/><p style="word-wrap: break-word;">海军有什么特性。</p><br/><p style="word-wrap: break-word;">海军只占有水面六个格子，占地较大，水域面积有限，攻击打对面横排的三个单位，克制陆军</p><br/><p style="word-wrap: break-word;">空军有什么特性。</p><br/><p style="word-wrap: break-word;">空军占有地面四个格子，可以打纵向3个单位，克制海军。</p><br/><p style="word-wrap: break-word;"> </p>
修理工厂	<p style="word-wrap: break-word;">修理工厂如何扩充？</p><br/><p style="word-wrap: break-word;">1.每日物资不给会赠送一个修理厂扩容。累计修理厂扩容券，扩容修理厂。2.80级职业天赋中的通用天赋，会有修理车间扩容</p><br/><p style="word-wrap: break-word;">修理工厂每天可以免费修理多少个？</p><br/><p style="word-wrap: break-word;">修理工厂每天可以免费修理的个数，是跟您的SR英雄韦德战地维修技能，五星可以修理53个.</p><br/><p style="word-wrap: break-word;">修理工厂免费维修的韦德是如何获得的？</p><br/><p style="word-wrap: break-word;">韦德是新手开区第一天，直接在活动页面领取的哦。如果您忘记领取，也可以在英雄招募中获取。</p><br/><p style="word-wrap: break-word;"> </p>
功能设置	<p dir="ltr" style="word-wrap: break-word;">如何更换皮肤？<span style="white-space: pre;"> </span>点击头像，点击城堡外观，找到你想切换的皮肤，点击立即使用即可</p><br/><p style="word-wrap: break-word;">如何切换铭牌？<span style="white-space: pre;"> </span>点击头像，点击铭牌，找到你想切换的铭牌，点击立即使用即可</p><br/><p style="word-wrap: break-word;">如何切换队列外观？<span style="white-space: pre;"> </span>点击头像，点击队列外观，找到你想切换的队列外观，点击立即使用即可</p><br/><p style="word-wrap: break-word;">如何切换城堡装饰?<span style="white-space: pre;"> </span>点击头像，点击城堡装饰，找到你想切换的城堡装饰，点击立即使用即可</p><br/><p style="word-wrap: break-word;">如何切换头像框？<span style="white-space: pre;"> </span>点击聊天界面，点击左下角的设置，点击后点击头像框设置，选择你想要更改的头像框，点击立即使用即可</p><br/><p style="word-wrap: break-word;">如何切换区服？<span style="white-space: pre;"> </span>点击头像，点击设置点击角色管理，点击新建账号，就可以选择自己想要去的区服了</p><br/><p style="word-wrap: break-word;">如何删除角色？<span style="white-space: pre;"> </span>想要删除现在的角色，需要先到其他区创建一个角色，在其他区的角色上，可以删除该角色。</p><br/><p style="word-wrap: break-word;">如何输入礼品码？<span style="white-space: pre;"> </span>点击头像，点击设置，点击礼品码，输入口袋奇兵的礼品码，点击确定即可兑换。</p><br/><p style="word-wrap: break-word;">如何查看自己的版本是否最新版本？    点击头像，点击设置，点击对话框右下角的修复版本，就可以更新到游戏的最新版本</p><br/><p style="word-wrap: break-word;">如何绑定游戏账号?<span style="white-space: pre;"> </span>    点击头像，点击设置，，点击账号绑定，选择微信还是QQ。（国外的是FB）</p><br/><p style="word-wrap: break-word;"> </p>
头像框如何设置	<p style="word-wrap:break-word">点击聊天----左下角设置----点击头像设置---挑选您想要使用的头像框---点击立即使用即可</p><p style="word-wrap:break-word"><br/></p>
举报、禁言	<p dir="ltr" style="word-wrap: break-word;">如果在游戏中遇到其他玩家不当言论的情况，可以在聊天框点击对方的头像选择举报或者联系客服提供聊天截图进行举报（建议同时点击对方头像选择屏蔽）<br /><br />如果在世界频道无法发言，可以联系客服确认是不是禁言状态，被禁言的话请等待禁言结束并留意措辞~</p>
性别，头像	点击头像可以选择修改性别和头像。如果修改自定义头像，需要修改下微信头像再重新登陆游戏等待一段时间就可以了（也可以通过修改微信性别来修改游戏角色性别）<br/><br/>ps：游戏内修改性别首次免费，第二次500钻石
地板之类的装饰是越多越好还是等级越高越好？	普通装饰物是3个低等级合成一个高等级，但是加成并不是变成三倍噢，所以在达到生效数量上限的前提下，等级越高加成越高，建议您达到最大生效数量并且有多余的装饰之后再考虑合成更高等级。
兵种克制一共有多少级？	一共有100级，满级的强化克制能产生120%的效果。
为什么别人研究科技比我用的金币少？	研究并升级联盟科技中的勤俭节约后，可以减少研究个人科技所需金币量噢。
为什么我没满级，但是经验满了没有升级	在您的经验数值那里现显示的会是一个约数，实际并未达到升级所需经验，您继续累积经验是可以升级的
怎么删除/置顶我和某个人的聊天记录	您可以在聊天界面右划打开聊天列表，再右划您要删除私聊记录的玩家头像会有删除按钮噢
怎么联系人工客服	您可以点击右上角联系客服图标，选择对应问题分类填写信息并提交给人工客服喔
如何删除士兵/金矿/兵营呢	请长按需要删除的建筑或单位，等待提示进度完毕，就会出现按钮[删除]。这时再点击删除，就可以了。士兵也可以在车库进行编辑-批量删除
如何关闭活动有关的跑马灯提示	请您点击头像，设置-设置-活动广播，点击关闭即可
我把装饰放在基地为什么buff没有改变	如果您拥有一整套套装装饰，放在背包-建筑里也会生效噢
长时间不登录游戏，基地会从地图上消失吗？	如果连续长时间不登录游戏，基地会被移出世界地图，下次登录后会重新分配坐标。基地等级越高，所需时间越久。
我为什么不能建造职业建筑	基地等级达到45级后才会开启职业功能。<br/>基地等级达到45级后，点击头像下方的职业选择图标确认您要选择的职业，就可以建造职业建筑啦
战报上的士兵为什么会发光呢	<p dir="ltr">是强化专精的特效，该兵种的强化专精达到9级开始有特效，之后每5级特效升级一次。</p>
我的护盾时间没到怎么就消失了	您可以点击头像-城市详情-护盾记录和邮箱-系统中的护盾消失邮件进行确认，在有护盾情况下有战争行为（比如攻击其他玩家基地）时护盾会消失。
游戏里的数量单位都有什么	游戏的数值显示单位为  k m b t aa bb cc dd ee ff ……1000进一位，比如1000=1k，1000aa=1bb
我怎么修改我的指挥官名字	请点击您的头像进入个人信息界面，在您的指挥官名字右边有个小铅笔，点击铅笔图标即可改名。<br/>首次修改免费，第二次开始需要消耗钻石，修改次数越多所需钻石会变多喔
我在哪能看到我收藏的坐标？	您可以进入世界场景，点击坐标右边的五角星，就能看到您收藏的坐标了，点击收藏夹左上角的齿轮可以选择删除坐标。
基地占满时很难滑动游戏界面，总是点到移动或合并单位	需要您点击头像-设置-再次点击设置，关闭【城内单位快速拖动】即可。
为什么我没有税收中心呢	因为新区和老区的部分成长线是不同的哦，如果您的自动收割机有快速收割这个功能的话， 就不会有税收中心了哦，税收中心的功能和快速收割的功能是类似的
我都已经是vip玩家了，为啥我的每日免费快速收割次数还是1次（新区）	每位玩家每日有6次快速收割机会，通过vip获得的收割机会是增加每日快速收割的次数上限，每位玩家每日的免费快速收割机会都是1次哦
我的防守部队设置好了怎么乱出英雄	防守部队的上阵规则是这样的，防守部队士兵足够时（至少有一个），就按照防守英雄来设置，防守英雄不在家，就按照排序（拥有守城技能的英雄》品质》等级）取其他英雄<br/>士兵不够，按照高级设置补充
我跟着别人攻打战锤怎么没有奖励	参与集结消灭战锤每天最多获得50次奖励，发起集结是没有奖励次数上限的
迁移码是什么？怎么使用？	官方App版本目前只能输入迁移码将已下架平台的角色迁移到官方平台。该功能并不支持平台间互相迁移。
我的军级（vip等级）怎么不显示了/怎么关闭显示	需要您点击头像-设置，再次点击设置，可以打开/关闭是否显示军级
我集结打战锤怎么总是显示集结失败啊	集结攻击战锤需要盟友加入一起集结才可以，同时集结的队伍是有士兵总量限制和参与人数限制，请您留意
军事演习活动的防守战报里强化不显示是怎么回事	在保存阵容时会使用指挥官当前所有的属性（不包含限时属性），如果有属性有更改，需要重新设置防守阵容
建议攻打宝藏守卫失败时返还相应体力	感谢您的反馈，目前在攻击黑暗军团、战锤、砰砰时，若队列到达时目标已经消失，会返还体力，您的建议也会转达给团队，希望也能有在游戏中实现。
远征行动	<p dir="ltr" style="word-wrap: break-word;"><strong>远征条件<span style="white-space: pre;"> </span></strong></p> <p style="word-wrap: break-word;">远征行动开启等级？<span style="white-space: pre;"> </span>14级开启。需要在建筑中建造远征基地。</p> <p style="word-wrap: break-word;">远征建筑如何建造？<span style="white-space: pre;"> </span>达到14级后，可以在内城，点击建筑，进行建造。</p> <p style="word-wrap: break-word;">远征建筑占几个格子？<span style="white-space: pre;"> </span>远征建筑占3X3地块。</p> <p style="word-wrap: break-word;">远征还有其他入口吗？<span style="white-space: pre;"> </span>点击功能列表，找到远征行动即可</p> <p style="word-wrap: break-word;"> </p> <p style="word-wrap: break-word;"><strong>远征玩法<span style="white-space: pre;"> </span></strong></p> <p style="word-wrap: break-word;">远征提示关卡暂未开放？<span style="white-space: pre;"> </span>目前仅仅只开放了260关，后续内容还请留意更新公告邮件，或者游戏公告牌哦！</p> <p style="word-wrap: break-word;">远征为什么不能用自己的士兵？<span style="white-space: pre;"> </span>远征的士兵是系统设置的好的。所有人都一样，根据关卡的提升，系统兵会逐步增多。</p> <p style="word-wrap: break-word;">远征中的机甲是怎么来的？<span style="white-space: pre;"> </span>远征中的机甲是远征中“快速战斗的功能”点击后冒险部队会合体成一个超级机甲，获得4小时挂机收益</p> <p style="word-wrap: break-word;">远征中快速战斗共有几次？<span style="white-space: pre;"> </span>远征快速能点6次哦！分别为免费，50，100，150，200，250</p> <p style="word-wrap: break-word;">远征中的战力跟什么有关？<span style="white-space: pre;"> </span>远征中的实际战力只跟自己的英雄，配件，兵种克制有关。</p> <p style="word-wrap: break-word;">远征行动中为什么无法跳过？<span style="white-space: pre;"> </span>第一大关卡都无法直接跳过，第一大关结束之后，从第二大关开始才能跳过哦。</p> <p style="word-wrap: break-word;">远征行动中如何查看小地图与大地图<span style="white-space: pre;"> </span>在远征行动主页面点击游戏正正方的小地图，可以查看当前关卡的信息，在点击右上角的“地图”就可以观看大地图信息</p> <p style="word-wrap: break-word;">远征行动中如何查看关卡信息？<span style="white-space: pre;"> </span>点击挑战，在挑战关卡Boss对话框中点击属性，就可以查看该关卡所有的属性。</p> <p style="word-wrap: break-word;">远征商店每日刷新几次。<span style="white-space: pre;"> </span>远征商店每日刷新一次。每日自动重置</p> <p style="word-wrap: break-word;">远征关卡能否重置？<span style="white-space: pre;"> </span>远征关卡目前无法重置。打过一次之后，不能再次攻击，但是有挂机可以领取额外收入。</p> <p style="word-wrap: break-word;"><span style="white-space: pre;"> </span></p> <p style="word-wrap: break-word;"><strong>远征排行名人堂<span style="white-space: pre;"> </span></strong></p> <p style="word-wrap: break-word;">远征行动中如何进入名人堂？<span style="white-space: pre;"> </span>名人堂是远征行动中的第一个达到此关卡的玩家。</p> <p style="word-wrap: break-word;">远征行动中同一时间为什么他的排名比我高？<span style="white-space: pre;"> </span>我们的显示时间只有时跟分，而排行榜会精确到毫秒。虽然是同一显示时间，依旧会有快慢。</p> <p style="word-wrap: break-word;">远征中如何查看其他玩家的属性？<span style="white-space: pre;"> </span>可以从远征排行榜中，点击玩家头像，点击属性就可以查看玩家过关的相关属性</p> <p style="word-wrap: break-word;">远征的排行榜中会暴露玩家的实力？<span style="white-space: pre;"> </span>远征排行榜中，只是玩家当时通关的记录，这个记录不会在改变，但是玩家的实力是会增加的哦</p> <p style="word-wrap: break-word;"><span style="white-space: pre;"> </span></p> <p style="word-wrap: break-word;"><strong>远征英雄<span style="white-space: pre;"> </span></strong></p> <p style="word-wrap: break-word;">远征中的战力指数有什么用？<span style="white-space: pre;"> </span>战力指数最高为100，远征挂机中，可以提高获取稀有道具的概率。战力指数跟上阵的英雄有关哦</p> <p style="word-wrap: break-word;">远征行动中关卡过不去了怎么办？<span style="white-space: pre;"> </span>可以提高英雄的等级，配件，跟相对应的兵种克制</p> <p style="word-wrap: break-word;">远征中主页面的英雄为什么修改后没有更换？<span style="white-space: pre;"> </span>请稍微等待2-3秒会自动更换场景后，更新英雄。</p> <p style="word-wrap: break-word;"><span style="white-space: pre;"> </span></p> <p style="word-wrap: break-word;"><strong>冒险币<span style="white-space: pre;"> </span></strong></p> <p style="word-wrap: break-word;">远征中我过了那么多关卡为什么没有冒险币？<span style="white-space: pre;"> </span>冒险币来源比远征挂机，您关卡过的越多，每分钟产出的冒险币也就越多哦！</p> <p style="word-wrap: break-word;">远征中冒险币来源？<span style="white-space: pre;"> </span>冒险币来源比远征挂机，您关卡过的越多，每分钟产出的冒险币也就越多哦！</p> <p style="word-wrap: break-word;">远征中点击了快速战斗为什么没有合成机甲？<span style="white-space: pre;"> </span>点击快速战斗后，稍微要等几秒，后续动画会自动合成机甲的哦。</p> <p style="word-wrap: break-word;"><span style="white-space: pre;"> </span></p> <p style="word-wrap: break-word;"><strong>远征礼包<span style="white-space: pre;"> </span></strong></p> <p style="word-wrap: break-word;">远征中的礼包为什么消失了？<span style="white-space: pre;"> </span>相应礼包是存在倒计时喔，所有倒计时结束就消失的，如果您在倒计时结束前没有购买的话，无法再购买到了呐。</p> <p style="word-wrap: break-word;">我有一个礼包在远征中错过了，还能在买吗？<span style="white-space: pre;"> </span>相应礼包是存在倒计时喔，所有倒计时结束就消失的，如果您在倒计时结束前没有购买的话，就无法再购买到了呐。</p> <p style="word-wrap: break-word;">远征中哪些关卡会有限时礼包。<span style="white-space: pre;"> </span>20关,60关,100关，130关，160关，210关过关后都会有限时礼包。</p> <p style="word-wrap: break-word;">远征中如何查看其他玩家的属性？<span style="white-space: pre;"> </span>远征中无法查看玩家现在的属性，只能查看当时过关卡时的属性。点击排行榜，点击想要查看玩家的头像，点击属性即可。</p> <p style="word-wrap: break-word;">远征商店中为什么我没办法买职业自选宝箱？<span style="white-space: pre;"> </span>请注意下面的解决需求。要达到指定关卡才可以购买哦</p> <p style="word-wrap: break-word;"> </p>
战锤奖励为什么没有得到	 type="text/css"><!--td {border: 1px solid #ccc;}br {mso-data-placement:same-cell;}--><p style="overflow-wrap: break-word;"><span style="font-size: 10pt; font-family: Arial;" data-sheets-value="{" data-sheets-userformat="{">根据游戏内设定，如果您参与盟友发起的战锤攻击，奖励最多只有50次。<br/>主动攻击不受影响。<br/><br/>同时，您可以在游戏内左下方的任务列表中找到战锤活动今日作为队员参与奖励领取次数。</span></p>
橙色碎片合成宝箱	<p style="word-wrap: break-word;"><span style="color: #191f25;">【<span style="color: #191f25;">橙色碎片合成宝箱</span>】</span></p><br/><p style="word-wrap:break-word">橙色碎片合成宝箱是消耗5个紫色万能碎片兑换1个橙色万能碎片<br />低级橙色碎片合成宝箱合成成功率20%，合成失败的话返还1个紫色万能碎片<br />高级橙色碎片合成宝箱的合成成功率是100%</p><br/><p style="word-wrap: break-word;"> </p>
钻石积分	<p style="word-wrap:break-word">​积分换豪礼<br></p><p style="word-wrap:break-word"><br></p><p style="word-wrap:break-word">活动期间消耗钻石可以获得钻石积分。</p><p style="word-wrap:break-word">积分可以在积分商城中兑换超值道具。</p><p style="word-wrap:break-word">历史积分累计到一定程度可以获得礼包购买资格。</p><p style="word-wrap:break-word"><br></p><p style="word-wrap:break-word">活动结束后积分清零。</p>
拯救难民	<p style="overflow-wrap: break-word;">活动期间，玩家在每日任务宝箱奖励中会获得求救信道具。使用求救信即可发现隐藏在基地附近的难民营。</p><p style="overflow-wrap: break-word;"><br>注意事项<br>1.只有使用求救信道具的玩家可以对该难民营发起集结，其他玩家无法对其发起集结，但可以参与集结；</p><p style="overflow-wrap: break-word;"><br>2.难民营被发现后，你只有30分钟的时间拯救他们。超过时间后，黑暗军团就会警觉，并将这座难民营转移，需要重新使用求助信道具来发现隐藏的难民营；</p><p style="overflow-wrap: break-word;"><br>3.参与集结奖励每日最多可获得10份（如果您参与超过10次上限，将会导致战报内没有奖励的情况出现哦~），但发起集结的奖励无每日次数限制。</p>
人气之星、最美佳人	<p style="word-wrap:break-word">不定期开启的人气之星活动~</p><p style="word-wrap:break-word">活动中通过赠送玫瑰和话筒提升排行榜积分。</p><p style="word-wrap:break-word"><br></p><p style="word-wrap:break-word">奖励包括【本服】人气之星、【全服】人气之星奖励，</p><p style="word-wrap:break-word">具体奖励可以进入活动中心-人气之星，左上角“！”查看。</p><p style="word-wrap:break-word"><br>可以通过活动获得特定活动皮肤：人气之星皮肤。</p><p style="word-wrap:break-word"><br>上述活动皮肤属性为：最高兵种合成等级+1，相当于合成士兵科技等级+1，不针对补给礼包内购买的士兵，如果海陆空同样最高级，可以同时享受。</p><p style="overflow-wrap: break-word;"><br>详细活动玩法，活动开放期间参考具体的活动开放时间和内容哦~</p>
补给争夺	<p style="word-wrap: break-word;">1.空投补给活动以2天为单位，隔天开启。 以联盟为单位进行的活动，开启时间由投票（无首领）或首领选择，每两天兑换活动会刷新一次兑换次数。</p><br/><p style="word-wrap: break-word;"><br />2.活动第一天0点，兑换活动将刷新兑换次数，并清除指挥官在上一轮活动中剩余的空投资源箱道具。</p><br/><p style="word-wrap: break-word;"><br />3.运输机将在地图上随机投放3轮空投。指挥官可以派兵前往空投点争夺空投资源箱。在搬运过程中，其他玩家可以对运输车队进行拦截。成功将空投箱运至要塞后，盟内所有成员均可在聊天界面领取空投资源箱奖励，同时搬运的指挥官将通过邮件额外获得奖励。</p><br/><p style="word-wrap: break-word;"><br />4. 争夺空投不消耗体力、同时不会取消已有的护盾保护状态。</p><br/><p style="word-wrap: break-word;"><br />特殊说明： <br />1.为了让更广大的指挥官能参与到活动中，我们将大幅增加每轮空投点的个数。并大幅提高橙色空投点包含的空投资源箱数量。同时兑换功能将适度调整道具数量。 <br />2.空投轮数将由3轮降低为2轮。</p><br/><p style="word-wrap: break-word;"> </p><br/><p dir="ltr">【补给发放】<br /><br />活动开始后，运输机每隔一段时间，将沿固定路线绕地图飞行一周。<br />飞行过程中，运输机会随机空投补给。<br />·玩家可以对补给发起行军，最先到达的用户获取补给，随即开始向联盟拥有的最近要塞输送。 <br /><br />【输送与阻击】<br />输送军团带有负面增益：降低行军速度、降低单位攻击、降低单位生命；输送过程中无法加速或撤回。<br />·非盟友玩家，可以针对输送发起阻击行军。<br />阻击战斗发生后，如果阻击一方获得胜利：<br />被掠夺一方，保留补给总量的10%道具，继续输送至原目标。<br />掠夺方获得剩余的补给，但输送时会获得负面增益。<br /><br />【活动奖励】<br />补给送达要塞后，每个盟友都将获得补给奖励。<br />补给需要在联盟频道领取，超过领取时间（10小时），奖励失效。<br /><br />【小提示】<br />在小地图，您可以看到运输机飞行路线，以及尚未输送的补给点。 <br />您可以攻占目标要塞或摧毁输送玩家的主城，致使输送队伍解散。 <br />部队被掠夺后，不会再进行额外战斗。<br />输送的补给量越大，行军速度越慢。</p><br/><p style="word-wrap: break-word;"> </p>
世界boss、boss来袭	<p style="word-wrap: break-word;">世界BOSS是在每天的凌晨4点、中午12点和晚上的8点开启（跨服战准备阶段和战斗阶段不开启），每日3次击杀boss活动只奖励一次，取最高排名进行奖励，所以会在每日第3个boss被击杀或者离开后发放奖励。</p><br/><p style="word-wrap: break-word;"> </p><br/><p style="word-wrap: break-word;">每轮活动中，您仅能针对boss发起最多不超过5次的攻击。</p><br/><p style="word-wrap: break-word;"><br />和BOSS战斗中如果队列中的士兵全输的时候，队列会立即返回，到家之后生成20%伤兵，目前由于上阵的士兵变多，可能不会全输了，队伍需要自动走回来了喔~</p><br/><p style="word-wrap: break-word;"> </p><br/><p style="word-wrap: break-word;"> </p>
最强指挥官-击杀敌兵	<p style="word-wrap:break-word">主动攻击其他基地可以获得积分。<br>Ps：攻击野怪不能获取积分。</p>
最强指挥官-提升战力	<p style="word-wrap:break-word">训练士兵、建造建筑可以提升战力<br>ps：放置强化道具是无法提升战力。</p>
最强指挥官-采集资源	<p style="word-wrap:break-word">采集石油/粮食：积分=采集量<br>采集金币（资源田）：积分和采集时间以及基地等级有关<br>采集金币（奇观）：和采集量、采集速度以及基地等级有关</p>
最强指挥官-肃清怪物	<p style="word-wrap:break-word">击杀野外怪物得到积分，怪物等级越高，积分越多。</p>
最强指挥官-疯狂造兵	<p style="word-wrap:break-word">生产兵种获得积分。训练士兵等级越高，积分越多。<br>Ps：造兵积分需要造兵完成后增加。</p>
最强指挥官-消耗金币	<p style="word-wrap:break-word"><span style="background-color: rgb(248, 248, 248); color: rgb(102, 102, 102); font-family: -apple-system, BlinkMacSystemFont, "Helvetica Neue", "PingFang SC", YaHei, "Source Han Sans SC", "Noto Sans CJK SC", "WenQuan Yi Micro Hei", "Segoe UI", Roboto, Oxygen, Ubuntu, Cantarell, "Open Sans", sans-serif; font-size: medium;">​消耗金币-消耗金币可获得积分（金币消耗量=积分获取量）</span><br></p><p style="word-wrap:break-word"><span style="background-color: rgb(248, 248, 248); color: rgb(102, 102, 102); font-family: -apple-system, BlinkMacSystemFont, "Helvetica Neue", "PingFang SC", YaHei, "Source Han Sans SC", "Noto Sans CJK SC", "WenQuan Yi Micro Hei", "Segoe UI", Roboto, Oxygen, Ubuntu, Cantarell, "Open Sans", sans-serif; font-size: medium;"><br></span></p><p style="word-wrap:break-word"><font color="#666666" face="-apple-system, BlinkMacSystemFont, Helvetica Neue, PingFang SC, YaHei, Source Han Sans SC, Noto Sans CJK SC, WenQuan Yi Micro Hei, Segoe UI, Roboto, Oxygen, Ubuntu, Cantarell, Open Sans, sans-serif" size="3"><span style="background-color: rgb(248, 248, 248);">积分档位需求的金币量会伴随等级提升而提升。</span></font></p>
最强指挥官	<p style="word-wrap:break-word">服务器开启后就会开放最强指挥官活动，可以在游戏内点击右侧活动中心按钮查看。</p><p style="word-wrap:break-word"><br/>各位指挥官每天达到制定的目标即可获得高额奖励，此活动每周循环。</p><p style="word-wrap:break-word">Ps：新开放的服务器在第一周是没有最强指挥官活动的哦~</p><p style="word-wrap:break-word"><br/>同时在每日0点结算今日积分，丰厚的排行奖励将以邮件形式送达。</p><p style="word-wrap:break-word"><br/>周一 ：消耗金币-消耗金币可获得积分（金币消耗量=积分获取量）</p><p style="word-wrap:break-word"><br/>周二 ：疯狂造兵-生产兵种获得积分（训练士兵等级越高，积分越多）</p><p style="word-wrap:break-word"><br/>周三 ：击杀战锤-击杀战锤获得积分（集结队长2分，队员1分。作为队员每日最多获得50分）</p><p style="word-wrap:break-word"><br/>周四 ：肃清怪物-击杀野外怪物获得积分</p><p style="word-wrap:break-word"><br/>周五 ：采集资源-采集资源数量（采集石油/粮食：积分=采集量；采集金币（资源田）：积分和采集时间以及基地等级有关；采集金币（要塞）：和采集量、采集速度以及基地等级有关）</p><p style="word-wrap:break-word"><br/>周六 ：提升战力-提升自身战斗力（训练士兵、建造建筑）</p><p style="overflow-wrap: break-word;"><br/>周日 ：击杀敌兵-攻击/防守其他玩家时杀死对方士兵获得积分（活动首周不开启）</p>
深海寻宝:探索时间优化	<div dir="ltr" data-zone-id="0" data-line-index="0" data-line="true">我们根据广大游戏玩家的建议，是让玩家有更好的收获体验，可以让玩家在保证休息的同时不影响宝箱探测操作，提升收益。<br />深海宝箱获取时间从<span style="color: #e03e2d;"><strong>6小时调整为8小时</strong></span>，同时也相应提升4种宝箱的奖励。</div> <div data-zone-id="0" data-line-index="0" data-line="true"><br />注意：目前开启曙光之地的服务器，深海寻宝活动暂时不变。</div>
深海寻宝:奖励升级	<p dir="ltr">深海寻宝升级后，宝箱更新为：<br /><strong>青铜海藏箱</strong>（含科技箱、训练加速、低级招募）<br /><strong>银蓝海藏箱</strong>（含金币箱、高级招募、1级强化）<br /><strong>紫金海藏箱、</strong><strong>红晶海藏箱</strong>（含橙色万能碎片、职业天赋加速8小时、专属技能宝箱）<br /><br />为了<strong><span style="color: #e03e2d;">保证玩家综合收益</span></strong>，因为宝箱获取时间的调整，各<strong><span style="color: #e03e2d;">宝箱奖励也同步进行了升级</span></strong>。<br /><br />注意事项：<span style="color: #e03e2d;"><strong>升级后的宝箱属于全新、更优秀的新宝箱</strong></span>。故原深海1级、2级等<span style="color: #e03e2d;"><strong>旧</strong><strong><span style="color: #e03e2d;">版</span>宝箱无法与之合成</strong></span>，我们预计后续开启<strong>宝箱兑换活动，</strong>方便您将旧版宝箱进行对应比例的兑换。</p>
为什么我无法参加首府争夺战	需要先加入一个联盟，才可以进行攻击操作哦。
首府中的首领表彰如何获得？	首领表彰是获得【首府争夺战】这个活动胜利的首领发给特定玩家的表彰礼包。<br/>小提示：跨服战胜利不会重置首领表彰噢
首领怎么给其他玩家任命官职	在世界地图中找到该玩家的基地，点击任命即可
为什么首府战打人没有得到积分？	首府争夺战的积分需要在首府争夺相关的建筑（首府、发射塔）里发生的战斗并且造成对方士兵损伤才能获得积分
为什么首府战没有投票时间？	首府战投票选择时间，一般只有在没有首领的情况下，如果有首领都是首领选择。
寻宝行会怎么玩？	在寻宝行会中，你可以通过完成行会任务获得藏宝图碎片。每9个藏宝图碎片可以合成一张藏宝图，进而触发4种宝藏事件！每种事件有着不同的玩法。（这句有词条treasure_guild_guide_01，下面那句需要单独翻译）<br/>可以点击寻宝行会界面左上角的感叹号进行了解噢
岛屿大作战每天可以打几次？	岛屿大作战每天可以重置2次，但是进攻的进度不会自动重置，比如昨天已经打完，今天需要先重置才能开始新的进度，那今天只能打2次；如果昨天重置成新进度后没有进行攻击，那今天还是新进度，打完再重置，可以打3次。
岛屿大作战里问号箱子给什么？	会随机触发地雷，或者随机获得增益效果
岛屿大作战里为什么有的是增益5%有的是增益8%	12层之后到问号箱子中随机出来的效果是8%，12层之前的都是5%
岛屿大作战里的增益是怎么来的？	增益是走到问号箱子，会随机触发炸弹或者获得一个增益效果；也可以选择增益岛屿
如何攻击岛屿大作战里的怪物	拖动直升机到各个岛屿会自动打滑动路线上的岛屿。或者挨个点击每层怪物，点击攻击
岛屿大作战共有多少层	共有15层
为什么个人保卫战只失败了一次就结束了？	个人保卫战一共有25波怪物攻城，失败三次或者打完25波就会结束噢
为什么个人保卫战活动还没结束，我却无法报名了	因为要预留出怪物攻城的时间，该活动的报名时间会在活动结束时间前两小时截止哦，还请下次提早报名
个人保卫战能重新打吗	个人保卫战每次活动只能打一次
为什么我拉空投的时候，我的全兵种攻击加成是负数	<p dir="ltr">运输空投的队列会有负面效果的哦<br />行军速度-全部-百分比：减90%<br />全部单位生命加成：减60%<br />全部单位攻击加成：减60%</p>
为什么我完成悬赏任务，我的晋升要求那里星级任务进度条没变化	是需要完成特定星级任务，才会计入该任务进度哦
为什么我的军票没了	提升军阶以及在军团商店购买道具都会消耗军票哦
军火大作战里中奖了但是没有获得奖励	每一个组合每轮最多完成一次，重复完成也只能获得一份奖励，不能重复获得喔<br/>例如同时连线有3个相同组合（不分排列顺序）的三等奖，实际只能得到1次三等奖奖励
为什么红蓝对对碰拿不到奖励	只有蓝色和红色对应的奖品同时点亮才能获得奖励哦
为什么我不能送花？	vip0-vip6的角色每天有送花数量限制：<br/>vip0：5<br/>VIP1：9<br/>VIP2：45<br/>VIP3：99<br/>vip4：520<br/>vip5：999<br/>vip6：1314<br/>VIP7及以上：无限制
玫瑰/麦克风怎么使用？	在人气之星活动期间，您可以在活动页面点击右侧的【送给好友】按钮，会弹出好友列表，可以选择一个好友进行赠送喔，也可以点击排行榜里的玩家赠送
完成了新兵充能的每日任务没有领到体力	新兵充能里完成任务领取的能量相当于获得积分，不是体力噢。能量累计到一定数量可以领取对应奖励。
为什么我的矿产大亨活动奖励列表里没有雷神元素？	目前是需要达到军级11以上才会有雷神元素与绿色材料自选箱
我的攻击属性明明增加了怎么打boss伤害没有提高？	对世界BOSS造成的总伤害，会因暴击、闪避、英雄技能触发情况有所浮动喔。如果您提升了攻击加成属性，建议您根据战斗回放对比下单次伤害是否增加了喔
我打了世界boss但是没有收到奖励	世界boss会在每天这三个时间（UTC + 8时区）：4:00、12:00（周日是12:05）、20:00出现，每次世界boss出现时，每个玩家最多可以攻击5次（每天三场共可以攻击15次）。奖励将在当天21:00（UTC + 8时区）根据单场最高名次，通过邮件发放奖励。
悬赏任务帝国狂战机械在什么地方？	领取该任务并点击前往，系统则会自动带您去该目标处 
请问天梯商店在游戏里会持续多久呢，是不是只会在跨服战期间出现	天梯商店会在金融中心一直存在，兑换道具也会不过期。
主线任务无法完成，已经超过任务需要合成等级怎么办？	再次合成高等级对应建筑即可完成任务
钻石积分活动期间错买玫瑰花了可以退吗	钻石积分活动期间消耗的钻石是无法退回的~还请您谨慎操作哦
活动中奖概率问题：为什么我总是抽不到大奖？	所有活动都是有概率可以获取奖励预览中的所有展示奖励的，相关概率所有玩家都是一样的~请多尝试一定可以中大奖的！
开过的活动以后还会开放么？	部分开过的活动以后是会定期继续开放的，请关注公告牌中的活动日历！
为什么深海寻宝紫色箱子不能合成传奇箱子	2级深海宝箱在合成时会随机合成为3级深海宝箱或传奇宝箱，但是3级深海宝箱无法合成传奇宝箱
为什么增援发射塔需要消耗体力	目前，在攻击和援助发射塔时，是会消耗体力的，会在援助发射塔的按钮上增加显示消耗体力。
英雄	<p style="word-wrap: break-word;">【英雄系统】<br />开放等级：5级<br />联盟按钮上方会有一个新的图标<br /><br />【英雄招募】<br />入口：英雄界面下方<br />种类：低级招募、高级招募<br />低级招募：每日5次免费，第二天刷新，没有免费次数的时候招募需要消耗一个低级招募券，可花费30钻石购买。可招募到蓝色、紫色英雄以及碎片。<br />高级招募：每24小时一次免费机会，没有免费次数的时候招募需要消耗一个高级招募券，可花费150钻石购买。可招募到紫色、橙色英雄以及碎片。<br />当英雄碎片达到10个时，可在英雄界面合成（有可合成标志）<br />当玩家获得英雄后，可看到属性、升级、升星页签。<br /><br />【精英招募】<br />可以针对不同兵种英雄进行招募，招募1次消耗一个精英抽卡券，可花400钻石购买，可招募到当前选定的海/陆/空的预览包含英雄。<br /><br />【限时招募】<br />不定期开启，实际招募英雄以及时间以当次活动为准<br /><br />【升级、升星】<br />升级：玩家消耗经验书可对单一英雄使用，使用后英雄获得经验，经验条满后，英雄升级，获得属性，英雄等级上限=20+英雄星级*20<br />升星：玩家消耗一定英雄碎片可对英雄进行升星操作，每一个大星分为5阶，每次升星操作为升一次阶级，升阶会给予英雄大量的基础属性，升星的时候还回给予统率属性。<br /><br /></p>
英雄羁绊	<p dir="ltr">1.英雄们根据彼此的经历和关系，形成不同羁绊组合<br />2.培养羁绊中的英雄，达成条件，便可激活英雄羁绊，获得属性加成<br />3.羁绊获得的属性为拥有属性，不论是否上阵英雄都可以获得加成</p>
英雄羁绊-科学力量	科学是人类和自然的战斗。泰蕾莎、赫兹、赖希施泰因、格罗博士作为自由同盟的尖端科技掌握者，他们加入军队的理由各有不同，唯一的相同点是他们都对黑暗军团的神秘科技充满兴趣。
英雄羁绊-盟军柱石	三军精英在此。盟军的高级将官个个实力超群，或者功勋卓越，或者背景深厚。这些强者是很难坐下来彼此真心合作的。
英雄羁绊-名师高徒	俗话说名师出高徒。爱德华中将在空军学院任教多年，为空军培养了很多的人才。最让人印象深刻的就是他发掘了索维吉——一个其他人都认为毫无优点的学员。
英雄羁绊-兄弟齐心	勠力同心，其利断金。亚历克斯从未想过自己需要弟弟来拯救。为了拯救哥哥，希度甘愿承担军事法庭的审判。在他心底，哥哥只能由他来超过。
英雄羁绊-幕后英雄	后勤乃是战争的基础。每次都能做好训练，修理，采集物资这些日常的事情，更显得克鲁佐，韦德，鲍勃们的珍贵和可靠。
英雄羁绊-流星火雨	死亡之剑常悬于头顶。在黑暗军团强大的空中力量下，战争初期，自由同盟空军付出了惨重的代价——大量优秀的飞行员和指挥官牺牲。天牧，里卡多，欧尼尔这些年轻军官，伴随着齐扎阁金属公司渐渐的成为了空中战役的主角。
英雄羁绊-金属狂潮	全速前进，金属巨浪。尼米兹，西蒙，汉默指挥的自由同盟舰队攻守兼备，虽然很多陆军支持者宣称黑暗军团海上力量最为薄弱，但只有他们才明白最终的胜利是多次会战后，不断积累才最终击败了黑暗海军，确立了海上优势。这为发起登陆战役打下了坚实的战略基础。
英雄羁绊-枪炮玫瑰	致命的诱惑，枪炮和玫瑰。在沙岛的艰苦训练让两个人建立了亲密而充满竞争的。尽管喀秋莎离开了沙岛，但不同的性格最终还是让娜塔莎和喀秋莎成为不一样的敌人噩梦。
英雄羁绊-战争之人	战争从来如此，战士永不凋零。无论什么样的战争，冲在前线的永远是陆军。毫无疑问，经历了前期的抵抗战争，中期的岛屿大作战，以及伟大的登陆战役后，泰温，布莱德雷，兰博们个个都是铁与血中历练而成的。
赤虎	<p dir="ltr"><img src="https://cdnimage-b.aihelp.net/FileService/UserFile/20210616035246549c82454caa1.png" border="0" style="max-width: 100%; max-height: 100%;" /><br /><br /><br />赤虎家境富庶，但他对继承家业毫无兴趣。一日，在居酒屋挥洒金钱随机为他人偿还酒钱后，得到了礼物--赤砂流剑书和名刀虎啸。在原主人展示了强大的剑术后，他兴致高昂的改名赤虎，开始修习剑道，直到战争开始。战争让他感觉到出世之旅冥冥展开。尽管他的剑术并不能时常击败强敌，但他背后的家族却不会任他发生意外，特别为他研制了能力强大的盔甲，而且一旦检测到他的愤怒情绪高涨时，就会出现一台神秘的机器...<br /><br /><br />————————<br /><br /><br />剑道守望者<br /><br /><br />赤虎开场即获得一定的怒气值使其能够快速释放怒气技能，让对方毫无防备的接受赤虎的怒火。<br /><br /><br />赤虎的专属技能拥有额外的属性：<br /><br /><br />3级：赤虎出战时，全体攻击力增加20%。<br /><br /><br />5级：无论是否出战，全体伤害减免2%。<br /><br /><br />7级：怒气技能随机发射的炮弹增加至5~11枚。<br /><br /><br />开场怒气值不得大于上阵格数。（大于9格时，初始怒气不受限制）<br /><br /></p> <p dir="ltr">如果开场怒气值大于7，剩余怒气值可累积到下一次。</p>
德卢雅尔	<img src="https://cdnimage-b.aihelp.net/FileService/UserFile/20210616035248634bca350557e.png" border="0" style="max-width: 100%; max-height: 100%;" /><br/><br/><br/>老德卢雅尔是联盟著名的矿物学家，长期艰巨和卓越的工作让他与女儿玛利亚·德卢雅尔逐渐生疏。所以学习优秀的小德卢雅尔逆反的拒绝了进入大学深造的机会，执意的加入军队。老德卢雅尔作为探索雷神矿的先驱，在不知情中无保护接触了雷神元素导致其身体严重受损，而目睹了雷神元素对盟军的帮助后，小德卢雅尔也意识到父亲工作的伟大。开始从父亲的研究中继续雷神矿物的研究。<br/><br/><br/>————————<br/><br/><br/>勘探者<br/><br/><br/>德卢雅尔是一位采集英雄，尤其善于雷神元素的采集。
法哈德	<img src="https://cdnimage-b.aihelp.net/FileService/UserFile/202106160352430759fbd0a9870.png" border="0" style="max-width: 100%; max-height: 100%;" /><br/><br/><br/>凭借家乡丰富的油气资源，法哈德迅速崛起。但他并不想只做一个石油大亨，时至今日，他的产业包含建筑、军工、航运等多个行业，他的客户也遍布世界，甚至包括黑暗帝国。随着大战的进行，黑暗帝国的连续违约让敏锐的法哈德迅速调整了策略——在断绝与黑暗帝国商业来往后，他带领自己的私人军队加入到自由同盟中。<br/><br/><br/>————————<br/><br/><br/>黄金之沙<br/><br/><br/>自带生命护盾可大幅增强我方全体单位的生存能力，攻击的积攒怒气将转化为致命一击！
维利尔斯	<img src="https://cdnimage-b.aihelp.net/FileService/UserFile/20210616035244467cd547d3962.png" border="0" style="max-width: 100%; max-height: 100%;" /><br/><br/><br/>维利尔斯天生瞳孔异色而被家乡人视为不祥，遭到父母遗弃。幸好得到白金汉公爵收养，公爵由着她的兴趣自由发展。凭借自己的努力她终于以明星的身份所为人称赞。战争期间，白金汉公爵参与大登陆战役，为了帮助父亲，她经常出入军营，为战士们打气加油，慰问劳军。她的歌声被军中将士称为彩虹之音，甚至很多战士们相信若能得到她的吻，则在接下来的战斗中不会陨落。<br/><br/><br/>————————<br/><br/><br/>异色之星<br/><br/><br/>不但在上阵时提升我方全兵种的进攻能力，场下的主动技能还可减免我方全兵种受到的伤害。<br/><br/><br/>温馨提示：<br/><br/><br/>1、主动技能在战区演习和次元矿洞作为防守方时不生效。<br/><br/><br/>2、英雄成长和技能提升导致彩虹之音的技能效果变化时，需再次使用才能生效。
914	<img src="https://cdnimage-b.aihelp.net/FileService/UserFile/202106160352569312922d43849.png" border="0" style="max-width: 100%; max-height: 100%;" /><br/><br/><br/>代号914是神秘的无面者之一，他们及其善于乔装，也被叫做千面人。据说他们的代号意味着曾使用过的面孔数量。一旦你足够重要，那么你身边的任何一个人，都有可能被无面者替代。无面者的信息很少，只有些类似背后得到自由同盟高层支持，或是他们在为黑暗帝国效力的传闻。<br/><br/><br/>————————<br/><br/><br/>无面者<br/><br/><br/>914将敌人的部署，攻击目标等战斗计划全盘截取，让我军处于极大的优势中。
寂	<img src="https://cdnimage-b.aihelp.net/FileService/UserFile/2021061603525410135ad5d1a47.png" border="0" style="max-width: 100%; max-height: 100%;" /><br/><br/><br/>如猫般无声无息的寂，极其善于隐蔽和接近敌人。她个人对于崇尚暴力的组织炙热之心非常痛恨。这些打着反战旗号的极端份子，经常采用极端手段清除一切他们认为的敌人。在经过一番周密的计划后，寂成功地在浴缸里结束了该协会会长的生命。她的身手被军方看中后，她便从家乡消失而进入沙岛。完成任务后，整容后的她潜伏在民间组织里，一个一个的消灭那些曾经追杀她的敌人。<br/><br/><br/>————————<br/><br/><br/>寂静<br/><br/><br/>寂同时丢出2个热能手雷，手雷爆炸对敌人造成大量伤害，碎片热能还将对敌人造成额外的燃烧伤害。
本	<img src="https://cdnimage-b.aihelp.net/FileService/UserFile/20210616035249940ac95989896.png" border="0" style="max-width: 100%; max-height: 100%;" /><br/><br/><br/>由单亲母亲抚养的本，在黑暗肮脏的街头环境中，逐渐成长为闻名街区的斗士。尽管各个帮派着争相拉拢，但母亲的教导使他洁身自好。不幸的是，母亲成为了胁迫他加入的筹码。为了拯救母亲他不得不以身冒险，最终反而被诬告。当时军部正在为“猎熊”行动物色人选，将他带入敢死队"渡鸦"。由于本在行动中表现出色，出人意料的带队而归，被表彰并晋升为队长。但因为某些原因，他拒绝表彰而退役，如今他已经加入到民间组织-伤痕之子中。<br/><br/><br/>————————<br/><br/><br/>大本钟<br/><br/><br/>本带队发起冲锋，攻击的部队奋勇当先不会受到伤害。
丹特	<img src="https://cdnimage-b.aihelp.net/FileService/UserFile/20210616035243756717776cb63.png" border="0" style="max-width: 100%; max-height: 100%;" /><br/><br/><br/>在加入空军特种部队侦查部队前，丹特是一位诗人，他的神话长诗充满想象和夸张，甚至他心底认为这场战争正是他的诗歌延续。很快，因反抗老兵侵犯而将对方打成重伤，受到审判，被迫加入了敢死队“渡鸦”执行“猎熊”行动。完成任务后，被调任到空中预警大队作为侦查僚机部队的指挥官。<br/><br/><br/>————————<br/><br/><br/>鹰眼<br/><br/><br/>使我方空军攻击力和生命大幅度提高。使用该英雄防守时，空中警戒会提供敌军情报，使英雄统率的海军、陆军也做好准备，获得同样的加强效果。
石太郎	<img src="https://cdnimage-b.aihelp.net/FileService/UserFile/20210616035245838a1f2315687.png" border="0" style="max-width: 100%; max-height: 100%;" /><br/><br/><br/>作为最早加入自由同盟的老兵，石太郎早就厌倦了不停的厮杀，长期的战斗中他摸出一套自己的生存法则——深挖战壕，不冲第一。经历多次战斗的石太郎，还完好如初就是最好的证明。当同盟需要从部队选拔采矿专业人才时，石太郎正好发挥自己擅于挖掘的特长，加入到采矿部队中，远离一线作战部队。<br/><br/><br/>————————<br/><br/><br/>工程标兵<br/><br/><br/>该英雄无论战斗还是采集都有很好的表现。
薇尔莉特	<img src="https://cdnimage-b.aihelp.net/FileService/UserFile/2021061603525867740b4e3bdc7.png" border="0" style="max-width: 100%; max-height: 100%;" /><br/><br/><br/>薇尔莉特是个天生的竞争者，对于任何事情她都充满领先他人的渴望，实际上她确实是嚼同一块泡泡糖最长时间的世界纪录保持者。追求胜利的性格让精英云集的自由同盟的军队里颇受关注，受到泰雷莎的帮助，她研制出一种带有磁性的胶体炸弹。<br/><br/><br/>————————<br/><br/><br/>泡泡杀手<br/><br/><br/>该英雄出战时，我方海军对敌军前排的攻击能力大幅提升
阿米莉亚	<img src="https://cdnimage-b.aihelp.net/FileService/UserFile/202106160352562184014fd01f6.png" border="0" style="max-width: 100%; max-height: 100%;" /><br/><br/><br/>出生在考古工地上的阿米莉亚的父母是著名的考古学者，受到家庭的熏陶，她也沉迷于此。在她的世界里，那些宝藏、古物是鲜活的，有声的，她能听到这些呼唤，因此她才能发掘出如此之多的文物古迹，甚至还有些奇怪的秘密。如今她全身心投入到这些奇怪秘密的研究中，谁能支付这巨大的经费，她就在会为谁工作。为了获得更多的资料和回报，她甚至愿意和部队一起行动。<br/><br/><br/>————————<br/><br/><br/>宝藏罗盘<br/><br/><br/>该英雄每次战胜黑暗军团、战锤、砰砰时会获得宝箱，每次掉落数量为英雄星级*1，,每日获取上限为英雄星级*4，宝箱内含各种道具及涂纹（涂纹可临时增加属性，多次使用同种涂纹持续时间叠加但属性不叠加，属性计算方式与城堡皮肤属性一致）<br/><br/><br/>狂热涂纹  提升全部单位攻击加成20%，持续30分钟<br/><br/><br/>自然涂纹  提升陆军单位生命加成20%，持续30分钟<br/><br/><br/>坚韧涂纹  提升部队伤害减免10%，持续30分钟    <br/><br/><br/>   <br/><br/><br/>英雄1-3星掉落镶银古箱<br/><br/><br/>橙色万能碎片  2% <br/><br/><br/>紫色万能碎片  9% <br/><br/><br/>狂热涂纹  10% <br/><br/><br/>自然涂纹  10%  <br/><br/><br/>小体力药剂  14%  <br/><br/><br/>科技宝箱*100  35%  <br/><br/><br/>核心建筑设计图*100  15%    <br/><br/><br/>金币砰砰宝箱*5  5%  <br/><br/><br/>   <br/><br/><br/>英雄4-5星掉落镶金古箱<br/><br/><br/>橙色万能碎片  4% <br/><br/><br/>紫色万能碎片  11% <br/><br/><br/>坚韧涂纹  10% <br/><br/><br/>狂热涂纹  10% <br/><br/><br/>自然涂纹  10%  <br/><br/><br/>大体力药剂  5%  <br/><br/><br/>科技宝箱*100  25%  <br/><br/><br/>核心建筑设计图*100  15%    <br/><br/><br/>金币砰砰宝箱*5  10%
克鲁佐	<img src="https://cdnimage-b.aihelp.net/FileService/UserFile/20210616035235807f2f1bf2a16.png" border="0" style="max-width: 100%; max-height: 100%;" /><br/><br/><br/>克鲁佐曾是一名优秀的陆战队员，曾经参与伟大的登陆战役，为了拯救队友而被炸伤，听力严重受损最终退役。退役后的第一份工作是陆战队教官，经他训练的战士都叫他闷拳，因为让他训练一天，脑子就像被打了几拳一样嗡嗡作响。当然，他依然是一名优秀的教官。<br/><br/><br/>————————<br/><br/><br/>闷拳<br/><br/><br/>拥有该英雄后每日都可快速训练一定数量的部队。
鹤	<img src="https://cdnimage-b.aihelp.net/FileService/UserFile/20210616035239127c201dad335.png" border="0" style="max-width: 100%; max-height: 100%;" /><br/><br/><br/>鹤的家族是神社的守护者。而她也因远超常人的力量、反应和勇气，被传为神明的再世。当战火燃烧到鹤的家乡时，她第一个站出来抵抗黑暗军团。这个兵员稀少的城镇，在鹤的领导下，凭借多次的奇袭战术，足足抵挡了黑暗军团的攻势3个月之久，直到自由联盟援军到达，最终保住了家园。被誉为“守护圣女”。不过，鹤拒绝了进入联盟军部任职的邀请，她希望继续守护她的家乡。<br/><br/><br/>————————<br/><br/><br/>守护圣女<br/><br/><br/>我方士兵普通攻击会增加怒气，攒满后发动强力攻击。此攻击对攻击力下降的敌军造成额外伤害（洛克菲尔德、泰蕾莎、贝尔、赤虎拥有攻击力下降特性，一次普通攻击最多积攒1点怒气）
戴安娜	<img src="https://cdnimage-b.aihelp.net/FileService/UserFile/2021061603524515455730394b2.png" border="0" style="max-width: 100%; max-height: 100%;" /><br/><br/><br/>戴安娜的养父是著名的空降特勤团的教官。他一次任务中因为受到了戴安娜的偷袭，而终止了任务。也因此惊异于她的无声无息的潜行技巧和精湛野外生存能力。在发现她并无家人后，他决心把戴安娜带回文明世界，成为她的养父，并向她学习野外生存技能。而小戴安娜在军营里则逐渐成为野外生存和作战的顶级专家。<br/><br/><br/>————————<br/><br/><br/>荒野精灵<br/><br/><br/>该英雄攻击黑暗军团、战锤和爱心砰砰时体力消耗降低，并对以上部队攻击力加成提高
贝塞尔	<img src="https://cdnimage-b.aihelp.net/FileService/UserFile/20210616035250627fdf94a988d.png" border="0" style="max-width: 100%; max-height: 100%;" /><br/><br/><br/>贝塞尔做事独断专行，暴力善变，但这却使得阿拉伯海上的小岛国不被黑暗军团所占领。他对内铁腕治国，将整个国家捏紧在一起；对外左右逢源，很少树敌。他是不介意与任何人联盟的，但也不会真正的和谁联盟：那些曾经算计过他的国家，最后都会付出充足的代价。<br/><br/><br/>————————<br/><br/><br/>独裁者<br/><br/><br/>该英雄出战时，使我军海军攻击力大幅度提升
吉拉	<img src="https://cdnimage-b.aihelp.net/FileService/UserFile/202106160352378056edd035abe.png" border="0" style="max-width: 100%; max-height: 100%;" /><br/><br/><br/>“一切杀不死我的，都将使我更强大”。吉拉是格斗界的传奇选手，她对胜利永远饥渴的追逐着。但如今她的一生之友弗洛伦丝加入了黑暗军团，成为了她的一生之敌。为了拯救挚爱，她将用自己的实力证明黑暗军团的荒谬和错误。<br/><br/><br/>————————<br/><br/><br/>狂暴之拳<br/><br/><br/>我方陆军增加伤害减免，受普通攻击怒气攒满后发动强力攻击。此攻击因敌方死亡而失去目标后，会改为在下次普通攻击释放。（敌军每次发动普通攻击，我方最多获得一点怒气。）
贝尔	<img src="https://cdnimage-b.aihelp.net/FileService/UserFile/20210616035252683387cb50020.png" border="0" style="max-width: 100%; max-height: 100%;" /><br/><br/><br/>战争摧毁了贝尔原本幸福的生活，她只能选择向黑暗军团复仇。她没有前往前线，因为她的家乡就是。“子弹可不会管你是不是女人”，在这句话的指引下，这副美丽外表下记着多达800名黑暗军团士兵的性命。凭借出色的追踪能力和百发百中的狙击枪法，她从不放过任何一个出现在瞄准镜中的敌人。<br/><br/><br/>————————<br/><br/><br/>西部执法官<br/><br/><br/>我方单位攻击时有几率额外攻击3个敌军。在建筑中防守时，被该英雄技能命中的敌军伤害会额外降低
洛克菲尔德	<img src="https://cdnimage-b.aihelp.net/FileService/UserFile/202106160352284929b3f7435e9.png" border="0" style="max-width: 100%; max-height: 100%;" /><br/><br/><br/>世界财富金字塔顶端的男人洛克菲尔德，他的财富因战争而来。但是作为慈善家的他却不希望人类在战争中残杀了。为此洛克菲尔德投入了大量的精力开发超级武器——一种巨大的，无人驾驶的，能够结束战争的武器。<br/><br/><br/>————————<br/><br/><br/>大财阀<br/><br/><br/>我军全部为空军时，对敌军进行全面轰炸，造成高额伤害并使敌方海军造成伤害降低
凯特库里	<img src="https://cdnimage-b.aihelp.net/FileService/UserFile/2021061603523443401e1aa9823.png" border="0" style="max-width: 100%; max-height: 100%;" /><br/><br/><br/>为了追猎到第一手的新闻，凯特库里甚至愿意在前线出生入死。正因为如此，她名声大噪。各国政要，财阀也都愿意接受这个英雄般的记者采访。为了新闻的客观性，凯特库里坚持自己保持足够的的独立。然而总有传闻说她在为联盟的情报机构工作。<br/><br/><br/>————————<br/><br/><br/>先驱者<br/><br/><br/>凯特库里提升所率领部队采集速度，在采集中的部队防守时，攻击速度提升
李艺媛	<img src="https://cdnimage-b.aihelp.net/FileService/UserFile/20210616035231090c3de0116ef.png" border="0" style="max-width: 100%; max-height: 100%;" /><br/><br/><br/>身为高句丽王室后裔，历史渊源使李艺媛成长在复国壮志的环境里，为此她饱受关注和严酷训练。随着父亲病亡，她在家族的地位一落千丈。这些冷暖反而坚定了她复国的信念。战争使得她的家乡成为各方势力争夺的焦点，李艺媛乘机组建部队，对抗黑暗军团，就此登上复国征程。<br/><br/><br/>————————<br/><br/><br/>太极后裔<br/><br/><br/>李艺媛会在战斗开始获得反击印记，提升高额的攻击和减伤属性，该属性会随单位攻击逐渐降低。
弗里德曼·赫兹	<img src="https://cdnimage-b.aihelp.net/FileService/UserFile/20210616035242400ce01815fff.png" border="0" style="max-width: 100%; max-height: 100%;" /><br/><br/><br/>著名科学家赫兹后裔，自由联盟科学家的核心，电磁学顶级专家。战争后期利用自己发明的仪器追踪到了黑暗帝国的藏匿之处，为联盟发动的地心远征指明了方向。同时对地下发现的115#元素进行深入研究，创建了超级武器实验室，并将该元素命名为雷神元素。<br/><br/><br/>————————<br/><br/><br/>电磁主宰<br/><br/><br/>战斗开始后，使敌方空军全体进入麻痹状态，受到所有伤害增加{0}%，且每次普通攻击都有{1}%几率失败。（技能释放不受影响）
亚瑟·哈里斯	<img src="https://cdnimage-b.aihelp.net/FileService/UserFile/20210616035257959ce8db20a68.png" border="0" style="max-width: 100%; max-height: 100%;" /><br/><br/><br/>在自由联盟空军取得优势前，亚瑟·哈里斯并不受到重视。而现在，作为密集轰炸论的推崇者哈里斯无人不知。他的轰炸机群在多次的战役中取得战略性的作用——黑暗军团的要塞、战舰、基础建筑都遭到了地毯轰炸。轰炸导致平民伤亡带来的负面影响，让他背上空中屠夫的称号，尽管他加速了黑暗帝国的败亡。<br/><br/><br/>————————<br/><br/><br/>轰炸机<br/><br/><br/>我方空军出战时，弱化对方的装甲，大幅提升我方空军对敌的输出
贝丽维	<img src="https://cdnimage-b.aihelp.net/FileService/UserFile/202106160352512818a1254fdbb.png" border="0" style="max-width: 100%; max-height: 100%;" /><br/><br/><br/>和科班出身的军官不同，贝丽维的指挥能力是源于她丰富的实战经验——在族人被黑暗军团抓捕杀害之后，贝丽维立誓要与黑暗军团战斗到底。她率领幸存者组成地方武装，进行艰苦而灵活的游击战。黑暗军团从她的家乡撤退后，贝丽维加入自由联盟，成为核心指挥官之一，继续实践她的誓言。<br/><br/><br/>————————<br/><br/><br/>海之寻猎者<br/><br/><br/>该英雄出战时，我方海军攻击能力大幅提升
卡塔琳娜	<img src="https://cdnimage-b.aihelp.net/FileService/UserFile/20210616035235144cc64821d8f.png" border="0" style="max-width: 100%; max-height: 100%;" /><br/><br/><br/>卡塔琳娜曾是世界上为数不多的海盗女王。很少人能真正明白她的强大之处——她居然敢于劫掠黑暗帝国的舰队。黑暗军团的通缉令使她勉强加入自由联盟的海军。很多人对她的出身颇有微词，但这并不阻碍卡塔琳娜成为面对强敌时的王牌先锋。<br/><br/><br/>————————<br/><br/><br/>海上女王<br/><br/><br/>出战该英雄时，使我方的海军单位生命和攻击均获得提升
布莱德雷	<img src="https://cdnimage-b.aihelp.net/FileService/UserFile/2021061603524929281db527fba.png" border="0" style="max-width: 100%; max-height: 100%;" /><br/><br/><br/>陆军上将布莱德雷，任装甲集团军司令，是一位理论实践兼备的军事家。相比泰温的步兵火炮协调作战，他更看重全机械化部队进行机动作战——通过运动始终寻找对手薄弱点，快速击败对手。在他的理论中，强调空军海军支援。而陆军，尤其是坦克，才是战争的发起者和终结者。<br/><br/><br/>————————<br/><br/><br/>战地壁垒<br/><br/><br/>战斗开始时，我方陆军会覆盖一层装甲，有效提升我方陆军在战场中的生存能力
尼米兹	<img src="https://cdnimage-b.aihelp.net/FileService/UserFile/202106160352265099f1f77dfa4.png" border="0" style="max-width: 100%; max-height: 100%;" /><br/><br/><br/>尼米兹是一位富有感染力的军人。他强调训练士兵的身体的同时，也要训练他们的心理。正因为如此，他的部队，不论战况如何，都具备顽强的战斗意志。在战争前期，他率领实力较弱的自由联盟海军，多次骚扰黑暗军团的海上补给线，给黑暗军团的海上行动制造了不少麻烦。<br/><br/><br/>————————<br/><br/><br/>海上骑士<br/><br/><br/>出战该英雄时，使海军进攻能力大大提升。
索维吉	<img src="https://cdnimage-b.aihelp.net/FileService/UserFile/2021061603522387600e0901026.png" border="0" style="max-width: 100%; max-height: 100%;" /><br/><br/><br/>索维吉是一个在军队长大的孤儿，内向到几乎不能与人正常交流。当他因为身体素质出众，被选入空军学院学习时，教授爱德华中将对他关照有加。他不但学到了丰富的航空知识，而且感受到了家人的温暖，逐渐开始愿意更多地表达自己，成长为一个全面优秀的飞行员。<br/><br/><br/>————————<br/><br/><br/>黑色闪电<br/><br/><br/>出战该英雄时，使我方空军对大量目标造成伤害，并可以对额外单位造成伤害。
哈特曼	<img src="https://cdnimage-b.aihelp.net/FileService/UserFile/20210616035240480cc28f7c915.png" border="0" style="max-width: 100%; max-height: 100%;" /><br/><br/><br/>空军学院的高材生，自由联盟的王牌飞行员，以及高超的战斗技巧和凶猛冷静的指挥，这都是孤傲的哈特曼荣誉墙上的记述。但“云雀”的出现打破了一切，哈特曼与她保持着相当的距离。因此他拒绝调任空军指挥部，继续在前线做为战斗机驾驶员奋战。<br/><br/><br/>————————<br/><br/><br/>捕食者<br/><br/><br/>出战该英雄时，空军有机会进行两次攻击，造成大量伤害
天牧	<img src="https://cdnimage-b.aihelp.net/FileService/UserFile/2021061603525939181353fb4bc.png" border="0" style="max-width: 100%; max-height: 100%;" /><br/><br/><br/>天牧还是建筑系的高材生时，黑暗军团入侵祖国，他毅然放弃学业，进入空军学院，加入到保卫国家的战斗中。因为优秀的战斗表现和帅气的外形受到媒体关注，在大众和普通士兵中如明星般的存在。在“夜袭”事件后，升任空军指挥官。他支持大空军的构想，是自由联盟最年轻的空军将领之一。<br/><br/><br/>————————<br/><br/><br/>天空守卫<br/><br/><br/>出战该英雄时，我方空军会获得强力护甲，减免敌人部分伤害，使得拥有强大火力的空军获得更强的生存能力
齐扎阁夫人	<img src="https://cdnimage-b.aihelp.net/FileService/UserFile/202106160352251870635b488ee.png" border="0" style="max-width: 100%; max-height: 100%;" /><br/><br/><br/>齐扎阁金属公司凭借设计制造的多种经典战机成为联盟最依仗的军工企业。而齐扎阁夫人则依靠自己的政治手腕成为联盟空军高级将领，她全力推进大空军体系——强调多种飞机协调作战。她冷艳骄任，言语毫不在意他人感受。但无人敢因此轻视她，多次战斗都能证明这一点。<br/><br/><br/>————————<br/><br/><br/>宙斯之盾<br/><br/><br/>出战该英雄时，使我方空军可以免疫伤害，对有强大攻击能力的空军来说是一个很好的生存补充。
爱德华	<img src="https://cdnimage-b.aihelp.net/FileService/UserFile/20210616035254781d82b4695f6.png" border="0" style="max-width: 100%; max-height: 100%;" /><br/><br/><br/>爱德华中将，现任联盟空军高级将领，因年轻时卓越战绩被称为“自由之翼”。自从联盟的港口被偷袭后，他的重心转为研究对舰作战方向。随着年岁增长，他将更多注意力转移到培养新人上，在空军学院教学时，发掘出不少的优秀军官。<br/><br/><br/>————————<br/><br/><br/>自由之翼<br/><br/><br/>出战该英雄时，使我方空军有几率造成致命一击，并且致命一击可以和暴击叠加。
娜蒂娅	<img src="https://cdnimage-b.aihelp.net/FileService/UserFile/202106160352271480af1136a94.png" border="0" style="max-width: 100%; max-height: 100%;" /><br/><br/><br/>娜蒂娅是联盟第一位空军王牌女飞行员，至今保持着击落467架敌机的骄人战绩。她所驾驶的齐扎阁金属制造的“云雀”超音速战机被，甚至没有一次负伤记录，其他人已经习惯把该战机等同于她本人了。<br/><br/><br/>————————<br/><br/><br/>云雀<br/><br/><br/>出战该英雄时，使我方空军在进行纵排攻击时的能力大大提升，对后续目标造成更大伤害。
格罗博士	<img src="https://cdnimage-b.aihelp.net/FileService/UserFile/2021061603524112056b287c2ac.png" border="0" style="max-width: 100%; max-height: 100%;" /><br/><br/><br/>格罗博士热衷于探索人体，为了证明他的观点，他设计了很多匪夷所思的人体优化改造方案。最为疯狂的是，他亲自改造了自己的大脑。说到疯狂很多人都会把他和疯狂博士联系在一起。可到底有多疯狂，只有他自己知道。但他的研究，真的挽救了很多联盟军官。<br/><br/><br/>————————<br/><br/><br/>生化狂人<br/><br/><br/>出战该英雄时，使我方空军在低血量的时候，爆发攻击力，有更大的翻盘希望。
里卡多	<img src="https://cdnimage-b.aihelp.net/FileService/UserFile/20210616035230455e3991ffe82.png" border="0" style="max-width: 100%; max-height: 100%;" /><br/><br/><br/>就算降落后，里卡多都不愿摘下飞行面罩，神经质和疯狂的性格也让人对他望而却步。也许是突发奇想，里卡多发明了空投遥控炸弹——通过使用监视器调整炸弹的下落地点，可以更精准杀伤敌方移动单位。而且不可理解的是，他好像视天牧为偶像。<br/><br/><br/>————————<br/><br/><br/>火药桶<br/><br/><br/>出战该英雄时，使空军进攻时，有更大的机会造成致命一击。
欧尼尔	<img src="https://cdnimage-b.aihelp.net/FileService/UserFile/202106160352258880d31573609.png" border="0" style="max-width: 100%; max-height: 100%;" /><br/><br/><br/>欧尼尔隶属联盟空军特种部队，是自由联盟第一个女特种兵。在全是男性的一线部队里，除了各种不方便外，最大的麻烦是性别歧视。不过，没用多久，欧尼尔就让这群铁血硬汉们改变了看法：各项测试全优，甚至最后的格斗测试中击败了所有对手。<br/><br/><br/>————————<br/><br/><br/>特种兵<br/><br/><br/>出战该英雄时，使空军进攻能力大大提升。
泰蕾莎	<img src="https://cdnimage-b.aihelp.net/FileService/UserFile/202106160352231794ec4ebc0e0.png" border="0" style="max-width: 100%; max-height: 100%;" /><br/><br/><br/>赖希施泰因在泰蕾莎的大学讲学时，被这个小姑娘的观点所吸引。后因此并邀请泰蕾莎加入他的研究项目之中。在这里，泰蕾莎才开始真正兑现自己的天才，成为一个海军武器的专家，主导研发了“塞壬”鱼雷——首次出战就有击沉表现的优秀武器。<br/><br/><br/>————————<br/><br/><br/>波涛之戟<br/><br/><br/>泰蕾莎可以通过自己的攻击，令对方的武器产生故障，令其攻击能力减弱
克洛伊	<img src="https://cdnimage-b.aihelp.net/FileService/UserFile/20210616035233797d407911d62.png" border="0" style="max-width: 100%; max-height: 100%;" /><br/><br/><br/>克洛伊是自由联盟海军史上最年轻的上校，超越了众多名将。很可惜，因为自己友军的失误，她因伤在后方修养了半年。在格罗博士的帮助下，她的右眼植入了超视晶体。从此，她拥有超视能力，能够有预见性的判断战场局势。不过最近她发现，长时间盯着屏幕看，她的右眼就会酸痛不止。<br/><br/><br/>————————<br/><br/><br/>绯红魅影<br/><br/><br/>克洛伊可以透过墙壁或敌人的装甲看到对方致命弱点并施加打击
梅莉达	<img src="https://cdnimage-b.aihelp.net/FileService/UserFile/20210616035227771d642cd1188.png" border="0" style="max-width: 100%; max-height: 100%;" /><br/><br/><br/>梅莉达火身材辣，语言热情，魅力四射，更重要的是她易于接近。这一切将她的智谋自然的隐藏起来——她擅长在不经意间获取你的信息，并利用这些信息找到敌人的性格弱点，并以此制造混乱，使敌人丧失战斗能力。作为前王牌特工，她成功执行过许多艰险而不为人知的任务。<br/><br/><br/>————————<br/><br/><br/>致命辣椒<br/><br/><br/>出战该英雄时，使得我方海军在对战陆军时，可以干扰敌方的进攻策略，并有几率使得敌方自相残杀。
甘索	<img src="https://cdnimage-b.aihelp.net/FileService/UserFile/202106160352417791198f95e92.png" border="0" style="max-width: 100%; max-height: 100%;" /><br/><br/><br/>曾在风景如画的碧蓝海域驻守的甘索，在黑暗帝国陆海空的炮火中洗礼了20天，受到双方军人的一致尊重。在突围过程中，脸部被弹片击中，险些殒命，后与亚历克斯一起接受过义肢改造，现任联盟海军作战部参谋，擅长指挥舰艇和岛屿的防御作战<br/><br/><br/>————————<br/><br/><br/>碧蓝堡垒<br/><br/><br/>使得我方守城时，守城能力极大提升，能更好的抵御进攻者。
希度	<img src="https://cdnimage-b.aihelp.net/FileService/UserFile/20210616035229822bf6901665a.png" border="0" style="max-width: 100%; max-height: 100%;" /><br/><br/><br/>希度和亚历克斯的双生兄弟，为了能超越强大的哥哥，他对亚历克斯充满敌意，直到在战亚历克斯被俘。虽然他拒绝化解他的敌意，然而为了营救哥哥，这位联盟最精锐海军陆战队总队长私自调动部队参与营救行动，最终被降职为中校。尽管如此，他也依然是进行渗透作战的专家。<br/><br/><br/>————————<br/><br/><br/>大洋之影<br/><br/><br/>出战该英雄时，使我方海军对大量目标造成伤害，再次的增加了海军的范围攻击能力。
西蒙	<img src="https://cdnimage-b.aihelp.net/FileService/UserFile/20210616035237160870f9cd801.png" border="0" style="max-width: 100%; max-height: 100%;" /><br/><br/><br/>常年泡在舰炮周围的西蒙，是联盟海军最优秀的机炮长。为了保持出色的身体素质，无论何时何地他都会想尽办法健身，并且还推出一本在无器械情况下，继续锻炼的指南手册，颇受军队欢迎。他是海军三杰中的最强攻击。<br/><br/><br/>————————<br/><br/><br/>追击者<br/><br/><br/>出战该英雄时，使海军进攻能力大大提升。
汉默	<img src="https://cdnimage-b.aihelp.net/FileService/UserFile/202106160352398611bf8ec0f30.png" border="0" style="max-width: 100%; max-height: 100%;" /><br/><br/><br/>战列舰在战争中逐渐失去主力的位置，但这个沉默的男人却从未放弃他心爱的舰船。汉默从小出生在军舰之上，对他来说战舰就是他的一切。他善于利用舰船的装甲，有效降低敌人的伤害，是海军三杰中的最强防御。<br/><br/><br/>————————<br/><br/><br/>海之盾<br/><br/><br/>出战该英雄时，使海军生存能力大大提升。
鲍勃	<img src="https://cdnimage-b.aihelp.net/FileService/UserFile/202106160352534619e8574fa2c.png" border="0" style="max-width: 100%; max-height: 100%;" /><br/><br/><br/>鲍勃是因为看了明星公益广告才加入联盟军队的。可惜他的体测并不是很出色，勉强合格，所以最后他被选中负责后勤保障工作。不知拒绝的性格倒是获得不少军官的友谊，也赢得了不少赞誉和信赖。<br/><br/><br/>————————<br/><br/><br/>技师<br/><br/><br/>非常适合攻打黑暗军团，一名优秀的增加进攻效率的英雄。
喀秋莎	<img src="https://cdnimage-b.aihelp.net/FileService/UserFile/202106160352364391854128d44.png" border="0" style="max-width: 100%; max-height: 100%;" /><br/><br/><br/>与娜塔莎一样，喀秋莎也是在少年时期被选中加入自由同盟的军队，但她生性英气直爽，使得“沙岛”放弃了对她的培养。从某个角度说，她被淘汰了。喀秋莎非常厌恶这段经历，从此她便带着绝不允许自己被淘汰的意志战斗，成长为黑暗军团最不想遇到的陆军指挥官。<br/><br/><br/>————————<br/><br/><br/>战场暴君<br/><br/><br/>喀秋莎可以通过强大的炮火覆盖，使对方多个单位同时受伤
李红玉	<img src="https://cdnimage-b.aihelp.net/FileService/UserFile/20210616035231814e467de01c1.png" border="0" style="max-width: 100%; max-height: 100%;" /><br/><br/><br/>和娇美的外表相比，红玉更以勇猛的战斗著称。她是唯一以全优成绩，受到所有教官的举荐而提前毕业的优秀人才。李红玉喜欢指挥战斗编队亲身参与前线战事，丰富的实战经验和诸多战绩也让她成为了历史上最年轻的女性的将官。<br/><br/><br/>————————<br/><br/><br/>坠天之火<br/><br/><br/>出战该英雄时，我方陆军可对敌方多个目标产生伤害，增加我方陆军的群伤能力
韦德	<img src="https://cdnimage-b.aihelp.net/FileService/UserFile/20210616035251994f84e2c1ed2.png" border="0" style="max-width: 100%; max-height: 100%;" /><br/><br/><br/>热爱摆弄机械的韦德具有强健的体魄，因而被球探发掘进入橄榄球联盟，并成为绰号“黑色黄金”的巨星。战争初期，为了鼓励更多年轻人进入军队，黑金带头加入了陆军。但由于他的明星属性和业余爱好，军部决定将他派遣到工兵修理部队中，这样既在前线也比较安全。<br/><br/><br/>————————<br/><br/><br/>黑金<br/><br/><br/>能让指挥官快速修理一些作战单位，是不可或缺的人才。
萨姆	<img src="https://cdnimage-b.aihelp.net/FileService/UserFile/20210616035224519ce47151fc2.png" border="0" style="max-width: 100%; max-height: 100%;" /><br/><br/><br/>当萨姆将军以高大的身躯、流血的眼睛带领部队冲锋到敌人阵地时，独眼巨人的称号就不胫而走。在首都保卫战中，他指挥的防空炮火更让他的威名传遍联盟。据说因为想要保留自己的称号，萨姆将军拒绝了格罗博士的修复手术。<br/><br/><br/>————————<br/><br/><br/>独眼巨人<br/><br/><br/>出战该英雄时，使我方陆军在面对空军时胜率大大增加，可以使敌方空军跳过一次攻击机会。
亚历克斯	<img src="https://cdnimage-b.aihelp.net/FileService/UserFile/20210616035222524d59e0a7cce.png" border="0" style="max-width: 100%; max-height: 100%;" /><br/><br/><br/>在被娜塔莎从集中营救出之前，酷刑拷打致使亚历克斯的左臂严重损坏，只能截肢更换义肢。在军部高层确认他没有泄露盟军信息后，他被派往黑暗帝国占领区担任反抗组织的指挥官，在敌后实施行动，配合自由同盟的敌后战略。卓有成效的破坏，让亚历克斯登上了黑暗帝国通缉榜单。<br/><br/><br/>————————<br/><br/><br/>自由之手<br/><br/><br/>出战该英雄时，给予陆军额外的燃烧属性，对敌人增加负面效果，产生高额伤害。
泰温	<img src="https://cdnimage-b.aihelp.net/FileService/UserFile/202106160353007361397c3a023.png" border="0" style="max-width: 100%; max-height: 100%;" /><br/><br/><br/>泰温将军曾担任自由联盟炮兵部队指挥官。他钟情且善用火炮，常常以巨炮为核心，辅以步兵及机械化部队协同作战。在战争前期，他的军团是陆上抵挡黑暗军团的重要力量。在多次战斗中，因陆战队与其配合紧密，泰温对陆战队指挥官兰博上尉信任有加。<br/><br/><br/>————————<br/><br/><br/>大地惊雷<br/><br/><br/>出战该英雄时，使我方陆军单位有几率进行2次攻击，直接打出伤害，击毙敌人。
兰博	<img src="https://cdnimage-b.aihelp.net/FileService/UserFile/20210616035232506feba6af40c.png" border="0" style="max-width: 100%; max-height: 100%;" /><br/><br/><br/>兰博是陆军王牌部队兄弟连上尉连长，是这群久经战斗历练的精英中的精英。在伟大的登陆作战中，这个连队作为先攻部队之一，在他率领下穿插到敌后，炸毁多座88mm炮台，挽救了更多的登陆部队。而兰博自己也曾潜入到敌方营地，一枪未开，消灭了十几个敌人，并最终顺利返回。<br/><br/><br/>————————<br/><br/><br/>爱国者<br/><br/><br/>出战该英雄时，可以使我方陆军单位忽视对方的闪避几率，使得每次攻击都是命中或者暴击，极大的增加了部队伤害。
赖希施泰因	<img src="https://cdnimage-b.aihelp.net/FileService/UserFile/2021061603523316110f7e485aa.png" border="0" style="max-width: 100%; max-height: 100%;" /><br/><br/><br/>绰号“分子盾”的赖希施泰因成功研制高分子装甲而以材料学家闻名。因此很多人都会忽略他作为建筑学家的贡献——他也是分层式战壕的设计者。当然，他也是个和善的老教授，很多新人也受到过他的提携。最近他在沉迷于研究新发现的115#元素。<br/><br/><br/>————————<br/><br/><br/>分子盾<br/><br/><br/>出战该英雄时，使陆军拥有更高的闪避几率，紫色英雄中对陆军唯一增加生命的英雄。
黑寡妇	<img src="https://cdnimage-b.aihelp.net/FileService/UserFile/2021061603523845895664aff3e.png" border="0" style="max-width: 100%; max-height: 100%;" /><br/><br/><br/>她是一名极其优秀的特工，也许你听过娜塔莎这个名字，但那也只是化名。少年时期，她被自由联盟的特工组织选中，远离家人的温暖在秘密基地“沙岛”进行艰苦的训练。成年后，她曼妙的身材和冷酷的行事风格，在完成任务的同时，也令无数异性死于非命，渐渐的黑寡妇反而成了她的代号。<br/><br/><br/>————————<br/><br/><br/>特工<br/><br/><br/>该英雄战斗时有几率使我方部队进行2次攻击。该英雄采集时可提升部队采集速度。
修理工厂免费维修的韦德是如何获得的？	韦德是在创建角色当天升级到7级后开启的活动中领取噢。如果您忘记领取，也可以点击右上角联系客服寻求帮助。
为什么我把技能从一个英雄上卸下来却无法装到另一个英雄身上？	每个英雄都有两个技能页面，需要您把两个页面的对应技能都卸下来，请再确认一下。
请问英雄天赋一共多少种？	天赋类型有：1 坦克攻击、2 坦克生命、3 海军攻击、4 海军生命、5 空军攻击、6 空军生命、7 全兵种攻击、8 全兵种生命、9 采集负重、10 金币采集速度、11 粮食采集速度、12 石油采集速度、13 野外采集速度、14 行军速度
英雄的天赋交换功能可以只交换一条天赋吗？	不能的，只能4条全部交换，包括解锁状态。<br/>只能和同品质并满星的英雄交换天赋。每次1000钻石
为什么我给英雄更换的天赋没有保存？	在给英雄更换天赋时，需要手动保存，才会替换掉原来的天赋。
我刚拿到的英雄没有升级礼包弹出	请注意，第一次招募的英雄会触发英雄升级礼包，而碎片英雄无法触发此礼物包，到目前为止，我们只有23位英雄的英雄升级礼包，比较新的英雄不包括在内，后续会陆续添加。 具体请以实际显示为准。
为什么我给英雄升星了但是还是X星	英雄每一星需要升级满5个阶段才会升级到下一个星级<br/>比如橙色英雄需要<br/>4*5次=20碎片到第2星，<br/>12*5次=60碎片到第3星，<br/>36*5次=180碎片到第4星，<br/>72*5次=360碎片到第5星
如何获得之前出过的限时招募新英雄？	对于限时招募活动的英雄，后续会增加获取途径，建议可以通过公告牌留意后续活动奖励以及礼包
英雄技能页面建议增加一个一键合成按钮	由于会有玩家使用多个相同类型的英雄，每个英雄都装备一套英雄技能的情况，所以如果一键合成可能会增加误操作的发生，目前研发团队还在评估这个问题，还没有明确的优化时间，请您谅解。
镜中鸟居	镜天水月共鸟居<br/>全体伤害加深，1级效果1%，每升1级增加1%。<br/>生效数量最多：1
阿拉伯之月-香烟袅袅	香气中铺满了虔诚<br/>金币产出增加+10%
阿拉伯之月-吉时已到	听我来报时<br/>全部单位攻击加成+3%
阿拉伯之月-星闪月明	光芒点缀着节日的庭院<br/>全部英雄防守值+100
阿拉伯之月-缤纷椰树	披上七彩的节日丝巾<br/>首个船坞容纳空间+15
阿拉伯之月-准备装填	有点点紧张，我还没准备好<br/>进攻时全军攻击力+6%
阿拉伯之月-甜美醇香	亲爱的朋友请安坐<br/>基础体力恢复速度+5%
阿拉伯之月-月下椰树	树影在灯光里舞蹈<br/>首个车库容纳空间＋15
阿拉伯之月-新月夜灯	夜空有弯月，夜宴有华灯<br/>首个机场容纳空间+15
阿拉伯之月-节日盛餐	远来的客人请品尝<br/>采集速度+5%
阿拉伯之月-轻纱帷幔	欢迎每一位。感谢你们到此做客。<br/>出征上限+2
伸缩门	小心有电！<br/>全部单位生命增加，1级效果1%，每升1级增加1%。<br/>生效数量最多：1
复活节彩蛋	兔子在哪里？<br/>陆军伤害减免，1级效果1%，每升1级增加1%。<br/>生效数量最多：1
小丑盒	打不着~打不着~<br/>全部单位闪避概率加成，1级效果3%，每升1级增加3%。<br/>生效数量最多：1
甜美倾心-游戏机	乐起来！<br/>全部英雄战争值+100
甜美倾心-美妙花盒	淡淡清香是酒是花还是TA<br/>首个船坞容纳空间+15
甜美倾心-水晶球	简简单单<br/>基础体力恢复速度+5%
甜美倾心-萌猫耳机	伴随着轻柔的声音<br/>全部单位攻击加成+3%
甜美倾心-黑巧克力	一点点苦，真的让人更着迷<br/>采集速度+5%
甜美倾心-真心彩妆	每个人都是多彩的！<br/>首个机场容纳空间+15
甜美倾心-金甜甜圈	香甜口味，是你也是她<br/>全部单位生命加成+3%
甜美倾心-多用键盘	进可攻，跪可守。谁用都可以。<br/>金币产出增加+10%
甜美倾心-萌萌玩具	好大的一个~就是很可爱想抱抱的。<br/>首个车间容纳空间＋15
甜美倾心-童话木马	来来往往，尽在时光<br/>出征士兵上限+2
炎火之像	涅槃重生，王者归来。<br/>全军攻击增加，1级效果3%，每升1级增加2%。<br/>生效数量最多：1
燃烧之羽	幻化成羽，转瞬即逝。<br/>全军生命增加，1级效果1%，每升1级增加1%。<br/>生效数量最多：1
军火箱	不用打开，肯定都是要命的家伙<br/>全军攻击增加，1级效果1%，每升1级增加1%。<br/>生效数量最多：1
紧急消防栓	紧急防火，安全第一！<br/>放置效果：当敌军当前兵力小于我方当前兵力的40%时，我军受到开场技造成的燃烧伤害降低95%。该装饰物不可升级。<br/>生效数量最多：1
禁区岗哨	保持距离，不得靠近！<br/>陆军生命增加，1级效果1.5%，每升1级增加1.5%。<br/>生效数量最多：1
烟花漫天	夜空中最美的花！<br/>全体单位攻击提高，1级效果2%，每升1级增加2%。<br/>生效数量最多：1
蓝色拳套	挑战者是气势正盛的，狂风急雨般的蓝色拳套！<br/>暴击率增加，1级效果2%，每升1级增加2%。<br/>生效数量最多：1
红色拳套	来自澳大利亚的，人称未尝败绩的红色拳套！<br/>暴击伤害增加，1级效果1%，每升1级增加1%。<br/>生效数量最多：1
惊涛怪浪-好运钱袋	新年了，我可以胖点的！<br/>金币产出增加+10%
惊涛怪浪-红色朗姆	红酒一杯，夕阳与自己<br/>首个机场容纳空间+15
惊涛怪浪-遗落宝藏	要啥有啥，谁拿是谁的。<br/>采集速度+5%
惊涛怪浪-海盗宝箱	多少年过去了，人呢？<br/>全部单位攻击加成+3%
惊涛怪浪-黝黑缆绳	栓得住铁锚，拉得动风帆。<br/>首个车库容纳空间＋15
惊涛怪浪-船长日志	斑驳的纸张，模糊的墨迹.....<br/>全部单位生命加成+3%
惊涛怪浪-咆哮火炮	轰的一声，谁也不见了<br/>进攻时全军攻击+6%
惊涛怪浪-悬挂小船	小是小了点，但是咱不漏。<br/>首个船坞容纳空间+15
惊涛怪浪-胜利女神	胜利女神仍将飞翔<br/>基础体力恢复速度＋５％
惊涛怪浪-搁浅海船	海上摇摇晃晃的哪有陆地平稳。<br/>出征上限+2
禁止入内	指挥官，请出示您的通行证。<br/>防守时伤害减免，1级效果1%，每升1级增加1%。<br/>生效数量最多：1
人鱼歌者	缥缈的歌声从海上传来。<br/>海军生命增加，1级效果1%，每升1级增加1%。<br/>生效数量最多：1
新年钟楼	行军速度提升。生效数量最多：1
新年篝火	全体伤害加深。生效数量最多：1
黄金战舰	黄金战舰附体，海军血量大增。生效数量最多：1
圣诞之家-极速驯鹿	没有红鼻子，我们也跑的很快。<br/>基础体力恢复速度+5%
圣诞之家-散落礼物	礼物太多了，只能随地放一下。<br/>护盾持续时间增加+10%
圣诞之家-金色雪橇	雪橇金光闪闪，焕然一新。<br/>进攻时全军攻击力+6%
圣诞之家-万年长青	青春常驻，人人所愿。<br/>首个机场容纳空间+15
圣诞之家-温暖雪袜	这是谁的礼物？塞得满满的。<br/>采集速度+5%
圣诞之家-快乐雪人	我很快乐，有点想动。<br/>全部单位生命加成+3%
圣诞之家-缤纷彩灯	华彩映照着笑脸<br/>首个船坞容纳空间+15
圣诞之家-幸福列车	呜~~~开心的2021年到啦！<br/>全军训练速度+5%
圣诞之家-许愿星树	心愿挂满在枝头<br/>首个车库容纳空间+15
圣诞之家-圣诞之家	圣诞老人正在准备礼物呢!<br/>出征上限+2
超级机炮塔台	全体英雄防守值提高。生效数量最多：1
超级弹药车间	全体英雄战争值提高。生效数量最多：1
清水翠竹	海军伤害减免。生效数量最多：1
感恩晚宴-稻草农妇	稻草夫人也换上新衣服吧。<br/>全军生命+3％
感恩晚宴-稻草农夫	辛苦一年的稻草人也休息一下吧<br/>全军攻击+3％
感恩晚宴-蔓越莓酱	偷偷尝一个蔓越莓该不会被发现吧？<br/>行军速度+3%
感恩晚宴-南瓜甜饼	整个秋天的香甜都在这里啦<br/>首个机场容纳空间空间+15
感恩晚宴-丰收花筐	沉甸甸的收获最为安心，希望来年依旧。<br/>采集速度提升+5%
感恩晚宴-自制面包	刚从烤箱里出来的面包才有家的味道。<br/>采集负重提高+5%
感恩晚宴-陈年红酒	这是充满记忆和香气的颜色<br/>首个船坞容纳空间+15
感恩晚宴-火热烤炉	<p dir="ltr">感受这个温暖的夜晚！<br />首个车间容纳空间+15</p>
感恩晚宴-感恩火鸡	没有火鸡的晚宴绝对是不完整的。<br/>基础体力恢复速度+5%
感恩晚宴-晚宴餐桌	摆满水果，前菜的晚宴餐桌，在等待着大餐上桌。<br/>出征上限+3
猎杀潜航	海军伤害加深。生效数量最多：1
惊笑城堡-惊笑城堡	休想活着离开这里，笑死你们。<br/>出征上限+3
惊笑城堡-鬼叫火树	什么鬼叫？那是我们在练习招待贵宾的保留曲目。<br/>首个船坞容纳空间+20
惊笑城堡-鬼笑火树	什么鬼笑？那是我们在练习贵宾吓尿时的保留曲目。<br/>首个机场容纳空间+20
惊笑城堡-孤独墓地	墓志铭上写着：敲门了吗？没敲就离我远点！听到了吗？<br/>采集速度+5%
惊笑城堡-被盗宝棺	我今年最少需要一个南瓜！<br/>额外提高兵种暴击10%
惊笑城堡-精致宝棺	哎~我披风夹住了，谁来帮我一下？<br/>全部单位生命加成3%
惊笑城堡-幽光烛台	骨粉做成蜡烛也是幽光摇曳，噼啪作响滴~<br/>行军速度+3%
惊笑城堡-恐怖南瓜	最最最最最最恐怖的南瓜才能成为骑士......的头！<br/>全军训练速度+5%
惊笑城堡-美味汤锅	不要太在意，那块肉并没有看着你啦~<br/>全部单位攻击加成3%
惊笑城堡-魔法黑猫	我就静静的看着你们......<br/>基础体力恢复速度+5%
巨人杀手	对战争之源攻击增加15%
探照哨塔	陆军伤害加深。生效数量最多：1
绿藤楹栏	陆军闪避几率增加。生效数量最多：1
荷塘月色	海军暴击几率增加。生效数量最多：1
假日套装-游艇	野外行军速度增加3%。生效数量最多：1
假日套装-蓝色躺椅	采集速度增加5%。生效数量最多：1
假日套装-红色躺椅	基础体力恢复速度增加5%。生效数量最多：1
假日套装-塔	全军训练速度增加5%。生效数量最多：1
假日套装-野餐场地	免费征税次数增加2。生效数量最多：1
假日套装-码头	全军攻击力增加3%。生效数量最多：1
假日套装-酒店	出征上限增加3。生效数量最多：1
小气球	空军暴击伤害增加。生效数量最多：1
救生圈	海军暴击伤害增加。生效数量最多：1
凉亭	陆军暴击伤害增加。生效数量最多：1
滑梯	体力上限增加。生效数量最多：1
假日小舟	海军训练速度增加。生效数量最多：1
假日垂钓	增加野外采集速度。生效数量最多：1
樱花树	陆军伤害减免。生效数量最多:1
海军纪念碑	受海军纪念碑鼓舞，海军建造速度增加。生效数量最多:1
爱神天使	空军训练速度增加。生效数量最多：1
黄金飞机	黄金飞机附身，飞机血量大增。生效数量最多：1
雪人	陆军伤害减免。生效数量最多：1
圣诞树	全体单位攻击增加。生效数量最多：1
感恩节火鸡	感恩节火鸡，使所有部队生命值提升。生效数量最多:1
沙袋堡垒	部队防守时伤害减免，最多生效:1
景观鲜花	野外采集时速度增加。生效数量最多：1
坦克纪念碑	受坦克纪念碑鼓舞，陆军训练速度大幅增加。生效数量最多:1
龙舟	(有几率)破损战舰修理时不降级。生效数量最多:1
黄金坦克	黄金坦克附体，坦克血量大增。生效数量最多：1
双子摇摇马	（有几率）破损坦克修理时不降级。生效数量最多：1
指挥官雕像	（有几率）训练坦克时立即完成。生效数量最多：1
礼物箱	训练速度增加。生效数量最多：5
长椅	行军速度加快。生效数量最多：5
幸运泉	金币产出增加。生效数量最多：5
高速公路	对黑暗军团行军速度略微加快。生效数量最多：100
紫色地板	训练速度略微增加。生效数量最多：100
灯笼	金币产出略微增加。生效数量最多：10
青苹果树	修理速度略微增加。生效数量最多：20
城墙	保护金币不被他人获得。生效数量最多：20
钻石商城里为什么没有双倍钻石了	钻石商城的每个钻石礼包只有前两次购买才是双倍钻石喔
如何切换城堡皮肤/铭牌/队列外观/城市装饰/迁城特效？	您点击头像进入个人信息界面，点击您要更换的外观界面，找到并使用对应的外观就可以啦
为什么我使用城堡皮肤时出现位置错误	基础皮肤之外的其他皮肤都是占4个格子，需要您基地的上方、左侧、右侧的格子没有障碍物噢
拥有属性和使用属性有什么区别，这些属性会叠加吗	以皮肤为例，拥有属性指的是只要您拥有了，相关属性就会生效，不管该皮肤是否在使用中，使用属性则需要您使用该皮肤才会生效。不同皮肤的拥有属性是叠加的；同一个皮肤的拥有属性和使用属性（使用中）也是叠加的。
我拿到队列皮肤为什么用不了（头像框，城堡皮肤）	需要您在背包里找到皮肤道具并点击‘使用’， 这样您就可以在皮肤界面使用该皮肤了
如何获得虚妄迷城皮肤	该城堡皮肤是永恒之地活动的个人排名奖励，后续会通过其他活动开放获取途径的，敬请期待
调查问卷相关问题	<div dir="ltr"><span class="text-only" data-eleid="5">1.同一个账号下多个角色无法领奖：近期我们进行了问卷系统的更新优化，每个账号只有一个角色能够领奖，同一位玩家多次填写问卷会造成问卷数据不准确的问题，望指挥官理解；</span> <br /><br /><span class="text-only" data-eleid="7">2.完成问卷无法领奖：问卷系统会根据您的回答进行判定，无法领奖可能是因为被系统判定为无效问卷，给您带来不好的体验十分抱歉，同时也希望下次能够站在问卷中看到您最真实的想法和反馈；</span> <br /><br /><span class="text-only" data-eleid="9">3.提交后显示英文界面：<span style="color: #e03e2d;">Survey monkey</span>是一款海外问卷<span class="text-only text-with-abbreviation text-with-abbreviation-bottomline">平台</span>，您重新进入可能会显示英语，这个是问卷平台默认设置，给您带来不便十分抱歉，之后我们会向平台反馈此问题。</span></div>
职业修改通知	<p style="word-wrap:break-word">目前在没有开放全明星锦标赛并且是旧职业系统的服务器和锦标赛中被淘汰的服务器开启了新的职业天赋系统。</p> <p style="word-wrap:break-word">该范围内的玩家跟随引导建造建筑“指挥学院”，即可开启新职业天赋。</p> <p style="word-wrap:break-word">1.版本更新时，所有指挥官的职业天赋将自动重置为未学习状态，因此我们将撤回所有指挥官的在外部队（系统强制撤回不会挟带采集资源，请您知晓），并为所有指挥官开启24小时保护，避免造成损失（有保护状态的，保护时间叠加）；<br />2.重置职业天赋后，过往学习天赋消耗的所有资源、道具会退还至背包。学习天赋消耗的时间会折算为等量加速道具一同放入背包。届时会有系统邮件通知各道具的退还数量；<br />3.“大元帅”额外技能槽镶嵌的技能在重置职业天赋后会自动放入背包中。“传奇工匠”在世界地图上建造的特有建筑会在重置职业天赋后自动消失。“战术大师”的“不败之军”士兵会在重置职业天赋后自动转换成80级普通士兵。“大科学家”已经或正在制造的特有道具都不会受到职业天赋重置的影响，但重新学习天赋前不可以制造新道具；<br /><strong>4.消耗“职业重选券”，可以在“战斗精英”与“机械大师”中任意切换，所学天赋进度会保留覆盖，指挥官可以同时积攒”战利品狗牌“与”机械齿轮“，更快速地学习天赋；</strong><br />5.消耗“专精职业重选券”，可以将当前学习的天赋重置，并退还资源；<br />6.后续天赋即将上线，敬请期待。<br /><strong>7.新职业和之前的老职业天赋架构有所不同，并增加、融合了一些职业天赋，所以可能使用返还的道具和资源无法达到老天赋系统的进度，建议您规划好新职业的研究路线。</strong></p>
游戏怎么上不去/打不开了呢？	<p style="word-wrap: break-word;"><span data-sheets-value="{"1":2,"2":"请您先确认服务器是否在维护中喔，如果没有在维护中，建议您更换其他网络环境并关闭游戏进程再重新登录看下喔如果问题依然存在，请您点击右上角联系客服-无法登录提供下您的角色信息和登录截图"}" data-sheets-userformat="{"2":10751,"3":{"1":0,"3":1},"4":{"1":2,"2":16508374},"5":{"1":[{"1":2,"2":0,"5":{"1":0}},{"1":0,"2":0,"3":3},{"1":1,"2":0,"4":1}]},"6":{"1":[{"1":2,"2":0,"5":{"1":0}},{"1":0,"2":0,"3":3},{"1":1,"2":0,"4":1}]},"7":{"1":[{"1":2,"2":0,"5":{"1":0}},{"1":0,"2":0,"3":3},{"1":1,"2":0,"4":1}]},"8":{"1":[{"1":2,"2":0,"5":{"1":0}},{"1":0,"2":0,"3":3},{"1":1,"2":0,"4":1}]},"9":1,"10":1,"11":4,"14":{"1":3,"3":1},"16":11}" data-sheets-textstyleruns="{"1":0,"2":{"2":{"1":3,"3":1},"3":"等线","4":11}}{"1":65,"2":{"2":{"1":2,"2":16711680},"3":"等线","4":11,"5":1}}{"1":77,"2":{"2":{"1":3,"3":1},"3":"等线","4":11}}">请您先确认服务器是否在维护中喔，如果没有在维护中，建议您更换其他网络环境并关闭游戏进程再重新登录看下喔<br />如果问题依然存在，请您点击右上角联系客服-无法登录提供下您的角色信息和登录截图</span></p>
我无法进行实名认证	<p style="word-wrap:break-word">根据中宣部统一使用实名认证接口的相关要求，网络游戏企业应在5月31日前完成中宣部实名认证系统接入，规定时间内未完成接入可能会影响游戏运营。<br />【口袋奇兵】已接入该系统，部分指挥官可能遇到如下问题：<br /><br />问：输入了实名信息进行验证，但状态一直显示【实名认证中】<br />答：近期为互联网产品接入该系统的高峰时期，数据量较大，审核过程中可能存在数据卡顿或延迟，耐心等待即可。<br /><br />问：输入了实名信息进行验证，但一直无法通过，导致【当日次数用尽】<br />答：为保证技术相关内容控制，每日实名认证上限次数为10次，该问题已与审核方反馈，目前还请您耐心等待次日刷新验证次数。<br /><br />问：没有居民身份证应该如何处理？<br />答：建议您通过户口所在地的应用商店下载游戏并安装，届时可以联系客服申请游戏角色迁移。如有其他的特殊问题或者需求，也可及时与客服联系。</p>
游戏非常的卡，怎么回事吖	<p style="word-wrap:break-word">可能是网络环境不稳定导致的，请您尝试更换其他网络环境再重新登录喔。<br />同时建议您定期更新App版本喔</p>
电子发票	<div id="header-div" class="layui-header"> <h2 dir="ltr">请仔细阅读开发票须知</h2> </div> <div id="center"> <div id="main-div"> <h3>为提升用户申请发票的流程体验，即日起【口袋奇兵】全面升级为电子普通发票。</h3> <p style="word-wrap: break-word;"><strong>若您有开发票的需求，请点击右上角联系客服选择【其他】分类。</strong></p> <br /><strong>开票须知：</strong> <h3>1.仅支持使用官方安卓版本app的用户通过支付宝、微信支付的订单申请电子普通发票。通过微信小程序、QQ游戏支付请联系腾讯公司申请开票；苹果手机用户请联系苹果公司申请开票。</h3> <h3>2.发票金额为实际支付的订单金额，不含折扣金额和使用优惠券的金额。</h3> <h3>3.电子普通发票是国家税务总局推行的有效收付款凭证，其法律效力、基本用途及使用规定同纸质发票。如需纸质发票可自行下载打印。</h3> <h3>4.组织机构（事业单位）开票，纳税人识别号可填写：组织机构代码或统一社会信用代码。</h3> <h3>5.用户应当确保所提供的电子邮箱地址的有效性与准确性，自行承担因提供电子邮箱地址错误产生的责任。</h3> <h3>6.不支持指定发票日期，仅支持开具申请日期以后的发票。</h3> <h3>7.为保证服务质量，单次开取发票总金额不得超过5万元。若需要开取的发票金额超限，可以在本次操作完成后对剩余订单重新申请开票。</h3> </div> </div>
アカウント保護	<p style="word-wrap: break-word;">・アカウントの共有や他人アカウントでのプレイは絶対におやめください。</p><br/><p style="word-wrap: break-word;">・チャットでご自身の情報やアカウントの情報を共有しないでください。</p><br/><p style="word-wrap: break-word;">＊アカウント紛失防止の為、SNSアカウントと紐付けることをお勧めいたします。</p><br/><p style="word-wrap: break-word;">手順は以下となります</p><br/><p style="word-wrap: break-word;">アイコン→アカウント→SNS連動</p>
职业	<p dir="ltr" style="word-wrap: break-word;">【转职】</p> <p style="word-wrap: break-word;"> </p> <p style="word-wrap: break-word;"><span style="color: #111f2c;">45级开启，<span style="color: #111f2c;">等级到达后，会在头像下方的区域出现按钮，点选后打开转职界面。选择职业后，游戏会短暂loading一下，再次进入游戏并点选转职的按钮，会引导玩家建造职业建筑。建造成功后，转职完成。</span></span></p> <p style="word-wrap: break-word;"> </p> <p style="word-wrap: break-word;"><span style="color: #111f2c;"><span style="color: #111f2c;"> </span></span></p> <p style="word-wrap: break-word;"> </p> <p style="word-wrap: break-word;"><span style="color: #111f2c;"><span style="color: #111f2c;">【<span style="color: #111f2c;">战斗精英和机械大师</span>】</span></span></p> <p style="word-wrap: break-word;"> </p> <p style="word-wrap: break-word;"><span style="color: #111f2c;"><span style="color: #111f2c;"><span style="color: #111f2c;">初始，玩家可以选择2个职业，分别为战斗精英和机械大师。</span></span></span></p> <p style="word-wrap: break-word;"> </p> <p style="word-wrap: break-word;"><span style="color: #111f2c;"><span style="color: #111f2c;"><span style="color: #111f2c;">战斗精英能够大幅强化玩家的战斗能力，机械大师则是增强发展的能力。</span></span></span></p> <p style="word-wrap: break-word;"> </p> <p style="word-wrap: break-word;"><span style="color: #111f2c;"><span style="color: #111f2c;"><span style="color: #111f2c;"> </span></span></span></p> <p style="word-wrap: break-word;"> </p> <p style="word-wrap: break-word;"><span style="color: #111f2c;"><span style="color: #111f2c;"><span style="color: #111f2c;">【狗牌、齿轮】</span></span></span></p> <p style="word-wrap: break-word;"> </p> <p style="word-wrap: break-word;"><span style="color: #111f2c;"><span style="color: #111f2c;"><span style="color: #111f2c;">升级职业技能过程中需要消耗道具，对应消耗规则为：</span></span></span></p> <p style="word-wrap: break-word;"> </p> <p style="word-wrap: break-word;"><span style="color: #111f2c;"><span style="color: #111f2c;"><span style="color: #111f2c;"><span style="color: #111f2c;">战斗精英--狗牌</span></span></span></span></p> <p style="word-wrap: break-word;"> </p> <p style="word-wrap: break-word;"><span style="color: #111f2c;"><span style="color: #111f2c;"><span style="color: #111f2c;"><span style="color: #111f2c;"><span style="color: #111f2c;">机械大师-齿轮</span></span></span></span></span></p> <p style="word-wrap: break-word;"> </p> <p style="word-wrap: break-word;"><span style="color: #111f2c;"><span style="color: #111f2c;"><span style="color: #111f2c;"><span style="color: #111f2c;"> </span></span></span></span></p> <p style="word-wrap: break-word;"> </p> <p style="word-wrap: break-word;"><span style="color: #111f2c;"><span style="color: #111f2c;"><span style="color: #111f2c;">【<span style="color: #111f2c;">专精科技天赋</span>】<br /></span></span></span></p> <p style="word-wrap: break-word;"> </p> <p style="word-wrap: break-word;"><span style="color: #111f2c;"><span style="color: #111f2c;"><span style="color: #111f2c;"><span style="color: #111f2c;">当第一页的基础科技天赋点满后，将开启专精科技天赋，需要玩家等级达到60级。</span></span></span></span></p> <p style="word-wrap: break-word;"> </p> <p style="word-wrap: break-word;"><span style="color: #111f2c;"><span style="color: #111f2c;"><span style="color: #111f2c;"><span style="color: #111f2c;"><span style="color: #111f2c;">战斗精英专精——（大元帅、战术大师），大元帅是大幅度强化英雄的职业，最终天赋是可以上阵3个英雄。</span></span></span></span></span></p> <p style="word-wrap: break-word;"> </p> <p style="word-wrap: break-word;"><span style="color: #111f2c;"><span style="color: #111f2c;"><span style="color: #111f2c;"><span style="color: #111f2c;"><span style="color: #111f2c;"><span style="color: #111f2c;">机械大师专精——（传奇工匠、大科学家）。传奇工匠可以在大地图上建造特殊的强化建筑。</span></span></span></span></span></span></p> <p style="word-wrap: break-word;"> </p> <p style="word-wrap: break-word;"><span style="color: #111f2c;"><span style="color: #111f2c;"><span style="color: #111f2c;"><span style="color: #111f2c;"><span style="color: #111f2c;"><span style="color: #111f2c;"> </span></span></span></span></span></span></p> <p style="word-wrap: break-word;"> </p> <p style="word-wrap: break-word;"><span style="color: #111f2c;"><span style="color: #111f2c;"><span style="color: #111f2c;"><span style="color: #111f2c;"><span style="color: #111f2c;"><span style="color: #111f2c;">【机械大师】<br /></span></span></span></span></span></span></p> <p style="word-wrap: break-word;"> </p> <p style="word-wrap: break-word;"><span style="color: #111f2c;"><span style="color: #111f2c;"><span style="color: #111f2c;"><span style="color: #111f2c;"><span style="color: #111f2c;"><span style="color: #111f2c;"><span class="keyword" style="-webkit-tap-highlight-color: rgba(0, 0, 0, 0); box-sizing: border-box; background-clip: padding-box; color: #111f2c;">机械大师</span><span style="color: #111f2c;">可以在大地图上建造采集建筑，完成（采金设施）（炼油设施）（建造谷仓）可以在大地图上建造对应的采集设施。</span></span></span></span></span></span></span></p> <p style="word-wrap: break-word;"> </p> <p style="word-wrap: break-word;"> </p> <p style="word-wrap: break-word;"> </p> <p style="word-wrap: break-word;"><span style="color: #111f2c;"><span style="color: #111f2c;"><span style="color: #111f2c;"><span style="color: #111f2c;"><span style="color: #111f2c;"><span style="color: #111f2c;"><span style="color: #111f2c;">【机械大师-资源设施】</span></span></span></span></span></span></span></p> <p style="word-wrap: break-word;"> </p> <p style="word-wrap: break-word;"><span style="color: #111f2c; font-family: Microsoft YaHei, Segoe UI, system-ui, Roboto, Droid Sans, Helvetica Neue, sans-serif, Tahoma, Segoe UI SymbolMyanmar Text, 微软雅黑;"><span style="font-size: 14px; white-space: pre-wrap; background-color: #ffffff;">每个种类的采集设施只能同时建造一个。</span></span></p> <p style="word-wrap: break-word;"> </p> <p style="word-wrap: break-word;">建造资源设施的消耗：<br />建造石油--消耗粮食，lv1-3级消耗依次为：120k→100k→80k<br />建造粮食--消耗金币，lv1-3级消耗依次为：120k→100k→80k</p> <p style="word-wrap: break-word;"> </p> <p style="word-wrap: break-word;">建造金币--消耗石油，lv1-3级消耗依次为：120k→100k→80k</p> <p style="word-wrap: break-word;"> </p> <p style="word-wrap: break-word;"> </p> <p style="word-wrap: break-word;"> </p> <p style="word-wrap: break-word;">资源设施可采集时间为<br />1级：6h<br />2级：7h<br />3级：8h</p> <p style="word-wrap: break-word;"> </p> <p style="word-wrap: break-word;"><span style="color: #111f2c; font-family: Microsoft YaHei, Segoe UI, system-ui, Roboto, Droid Sans, Helvetica Neue, sans-serif, Tahoma, Segoe UI SymbolMyanmar Text, 微软雅黑;"><span style="font-size: 14px; white-space: pre-wrap; background-color: #ffffff;">采集设施放置后需要时间建造，建造完毕后进入自动产出资源状态。（无需派遣士兵采集）</span></span></p> <p style="word-wrap: break-word;"> </p> <p style="word-wrap: break-word;"><span style="color: #111f2c; font-family: Microsoft YaHei, Segoe UI, system-ui, Roboto, Droid Sans, Helvetica Neue, sans-serif, Tahoma, Segoe UI SymbolMyanmar Text, 微软雅黑;"><span style="font-size: 14px; white-space: pre-wrap; background-color: #ffffff;">资源设施进入采集状态后，盟友可以进入采集。</span></span></p> <p style="word-wrap: break-word;"> </p> <p style="word-wrap: break-word;"><span style="color: #111f2c; font-family: Microsoft YaHei, Segoe UI, system-ui, Roboto, Droid Sans, Helvetica Neue, sans-serif, Tahoma, Segoe UI SymbolMyanmar Text, 微软雅黑;"><span style="font-size: 14px; white-space: pre-wrap; background-color: #ffffff;">建造完毕后的资源设施拥有一定耐久，被攻击会导致耐久降低，耐久降低至0后，资源设施会被摧毁。</span></span></p> <p style="word-wrap: break-word;"> </p> <p style="word-wrap: break-word;">资源设施耐久降低规则：防守胜利不掉，失败减少30-150。</p> <p style="word-wrap: break-word;"> </p> <p style="word-wrap: break-word;"><span style="color: #111f2c; font-family: Microsoft YaHei, Segoe UI, system-ui, Roboto, Droid Sans, Helvetica Neue, sans-serif, Tahoma, Segoe UI SymbolMyanmar Text, 微软雅黑;"><span style="font-size: 14px; white-space: pre-wrap; background-color: #ffffff;">ps：如果是采集盟友的资源设施，</span></span>3级开始建筑才比直接采集有优势哦~</p> <p style="word-wrap: break-word;"> </p> <p style="word-wrap: break-word;"> </p> <p style="word-wrap: break-word;"> </p> <p style="word-wrap: break-word;">【战斗精英--战斗礼物】</p> <p style="word-wrap: break-word;"> </p> <p style="word-wrap: break-word;">战斗礼物研究至3级后，击杀中立单位后，可以额外获得额外奖励。</p> <p style="word-wrap: break-word;"> </p> <p style="word-wrap: break-word;">中立单位---目前仅针对小怪。</p> <p style="word-wrap: break-word;"> </p> <p style="word-wrap: break-word;"> </p>
跨服天梯赛	<p style="word-wrap:break-word">【匹配阶段】<br/></p><p style="word-wrap:break-word"><br/></p><p style="color: rgb(255, 76, 65); font-family: -apple-system-font, BlinkMacSystemFont, " helvetica="" pingfang="" hiragino="" sans="" microsoft="" yahei="" font-size:="" letter-spacing:="" text-align:="" white-space:="" background-color:="" box-sizing:="" border-box="" overflow-wrap:="" break-word="" p="" span=""><span style="margin-top: 0px; margin-bottom: 0px; padding: 0px; max-width: 100%; clear: both; min-height: 1em; color: rgb(51, 51, 51); font-family: -apple-system-font, BlinkMacSystemFont, " helvetica="" pingfang="" hiragino="" sans="" microsoft="" yahei="" letter-spacing:="" text-align:="" background-color:="" p="" font-size:="" white-space:="" box-sizing:="" border-box="" overflow-wrap:="" break-word="">占领敌方控制的要塞（在真正获得要塞指挥权时，每名身处要塞的玩家可获得60分）。</span></p><p style="word-wrap:break-word"><br/></p><p style="word-wrap:break-word">注意：<br/></p><p style="word-wrap:break-word">1.前线堡垒、导弹发射井不需要占领时间，攻打下的瞬间即交换控制权。<br/>2.区域要塞有占领时间，是固定值。<br/>3.首府有占领时间，随着战斗时间的延长，占领时间将逐渐缩短。</p><p style="word-wrap:break-word">若直到战斗阶段结束，两服都没能成功占领对方首府，则占领区域数量多的服获得胜利。</p><p style="word-wrap:break-word">若两服占领区域数量一致，则两服同时判负。</p><p style="word-wrap:break-word"><br/></p><p style="word-wrap:break-word">【领奖阶段】</p><p style="word-wrap:break-word"><br/></p><p style="word-wrap:break-word">在领奖阶段，指挥官可以根据跨服战过程中的表现在活动界面领取奖励。</p><p style="word-wrap:break-word">系统也会自动发放“跨服战胜利奖励”及“杀敌排名奖励”。</p><p style="word-wrap:break-word"><br/></p><p style="word-wrap:break-word">【特殊说明】</p><p style="word-wrap:break-word"><br/></p><p style="word-wrap:break-word">1.部分活动暂时关闭：</p><p style="word-wrap:break-word">在战斗阶段，补给争夺和世界boss活动将暂时关闭。</p><p style="word-wrap:break-word">2.联盟相关功能暂时关闭：</p><p style="word-wrap:break-word">在战斗阶段，联盟相关的功能将暂时关闭。指挥官无法成立、加入、退出联盟，也无法进行科技捐献。</p><p style="word-wrap:break-word">3.新增跨服聊天：</p><p style="word-wrap:break-word">匹配在一起的两服指挥官可以在新增的跨服聊天频道中交流。</p><p style="word-wrap:break-word">4.伤兵迁服功能：</p><p style="word-wrap:break-word">若身处敌服的您想回到本服，可以点击前线堡垒进行迁回。<br/></p><p style="word-wrap:break-word">其中通过己方占领的前线堡垒可以无伤迁回本服，通过地方占领的前线堡垒会以一定比例士兵为代价迁回本服。</p><p style="word-wrap:break-word">5.在《准备阶段》《战斗阶段》过程中，玩家无法攻击“相同服务器归属”的玩家。</p><p style="word-wrap:break-word"><br/></p><p style="word-wrap:break-word">【时间调整】</p><p style="word-wrap:break-word">11月24日起，</p><p style="word-wrap:break-word">首府战：由《每周六13:00~15:00》调整为《每周日10:00~12:00》</p><p style="word-wrap:break-word">跨服战：由《周一至周六捐献，周日10:00~12:00战斗》调整为</p><p style="word-wrap:break-word">捐献阶段：周一00:00-周六18:59</p><p style="word-wrap:break-word">准备阶段：周六19:00-周六20:59</p><p style="word-wrap:break-word">战斗阶段：周六21:00-周六22:59</p><p style="word-wrap:break-word">领奖阶段：周六23:00-周日23:59</p><p style="word-wrap:break-word">后续活动时间如有调整，可关注游戏内公告以及活动页面。</p><p style="word-wrap:break-word"><br/></p><p style="word-wrap:break-word"><br/></p><p style="overflow-wrap: break-word;"><br/></p>
龙行天下	万流争先！<br/>出征士兵上限增加，1级效果1，每升1级增加1。<br/>生效数量最多：1
春苔石灯	春山小苔点新灯<br/>进攻时全体伤害减免，1级效果1%，每升1级增加1%。<br/>生效数量最多：1
纸花灯竿	流光花影向谁去<br/>全体英雄防守值提高，1级效果200，每升1级增加100。<br/>生效数量最多：1
我怎么被禁言了？	您的角色可能是由于刷屏被系统检测到后禁言了，请您留意发言时的禁言提示，建议您不要频繁发送纯表情或同样的消息以免被系统检测到刷屏行为导致被禁言。
联盟保卫战如何能打高分？	建议不要急着打，联盟保卫战是联盟成员的集体活动，所以先准备充足的精科导弹，人员齐备之后再开启，并沟通好在什么时间点一起使用精科导弹对怪物进行削弱，以免削弱进度不满造成浪费。
精科导弹有什么用	在联盟保卫战怪物攻城期间，点击攻城怪物对其进行削弱，削弱进度累计满之后才会生效噢
精科导弹哪里获取？	<p dir="ltr">在联盟保卫战活动开放期间消灭黑暗军团有一定概率获得精科导弹。</p>
联盟保卫战积分如何获得	可以通过参与防守消灭攻城怪物、使用精科导弹削弱怪物或修理联盟堡垒获得积分
如何知道那个联盟堡垒在参加联盟保卫战	可以点击活动，点击前往堡垒，或者查看堡垒，就可以找到参与活动的联盟堡垒。
联盟保卫战时如何参与防守	可以点击开启联盟保卫战的联盟堡垒，点击之后点击驻守，再点增员就可以参加。
怎么才能开启联盟保卫战	玩家至少有一个联盟且联盟有一个联盟堡垒。由R5在活动期间报名开启。
为什么我的联盟商店里会显示折扣	这个与联盟科技--联盟内购有关的哦
联盟科技里的联盟福利在哪里可以领取	在普通联盟礼物页面里就可以领取哦
我们的盟主很久没上线了怎么办？	您可以点击联盟-设置-罢免盟主，尝试取代原盟主成为盟主。<br/>R4需要盟主离线5天后才能取代盟主，R3需要10天，R2需要15天，R1需要20天。<br/>我们无权删除或调整联盟中的任何联盟成员，感谢您的理解
我没有被打，为什么被随机迁城了？	如果退出联盟后，基地还在原联盟的领地内，再次登录时会被重新分配坐标，请您留意系统提示喔
怎么邀请盟友迁城？	R5和R4可以在世界地图点开联盟堡垒-邀请迁城，然后在弹出的联盟成员中选择要邀请的盟友。点击自己位置的按钮可以邀请全盟成员迁城
盟友消灭战锤后怎么没有联盟普通礼物	 目前普通联盟礼物的获取上限是1000，您可在普通礼物界面左下方查看每日礼物上限数量与刷新时间
为什么我看不到盟友发的金币求助	只能看到不高于自己2级以上的盟友的金币帮助请求喔。比如10级看不到12级以上的盟友的金币帮助请求。
联盟礼物里的稀有礼物可否加一个一键领取功能呢	目前的设定是，稀有联盟礼物达到10个时可以一键领取10个。